Kecamatan,Toilet Guru P Baik,Toilet Guru P Rusak Ringan,Toilet Guru P Rusak Sedang,Toilet Guru P Rusak Berat,Toilet Guru P Rusak Total,Toilet Guru P Total
Kec. Kepulauan Seribu Utara Kab. Kepulauan Seribu,0,2,0,0,0,2
Kec. Tanah Abang Kota Jakarta Pusat,32,2,0,0,0,34
Kec. Menteng Kota Jakarta Pusat,9,1,0,0,0,10
Kec. Senen Kota Jakarta Pusat,11,3,0,0,0,14
Kec. Johar Baru Kota Jakarta Pusat,3,1,0,0,0,4
Kec. Cempaka Putih Kota Jakarta Pusat,15,3,0,0,0,18
Kec. Kemayoran Kota Jakarta Pusat,17,1,0,0,0,18
Kec. Sawah Besar Kota Jakarta Pusat,17,5,0,0,0,22
Kec. Gambir Kota Jakarta Pusat,12,2,0,0,0,14
Kec. Penjaringan Kota Jakarta Utara,47,3,0,0,0,50
Kec. Pademangan Kota Jakarta Utara,3,1,0,0,0,4
Kec. Tanjung Priok Kota Jakarta Utara,31,7,0,0,0,38
Kec. Koja Kota Jakarta Utara,15,3,0,0,0,18
Kec. Kelapa Gading Kota Jakarta Utara,38,4,0,0,0,42
Kec. Cilincing Kota Jakarta Utara,15,3,0,0,0,18
Kec. Kembangan Kota Jakarta Barat,26,5,0,0,0,31
Kec. Kebon Jeruk Kota Jakarta Barat,23,3,0,0,0,26
Kec. Palmerah Kota Jakarta Barat,8,2,0,0,0,10
Kec. Grogol Petamburan Kota Jakarta Barat,34,2,0,0,0,36
Kec. Tambora Kota Jakarta Barat,11,1,0,0,0,12
Kec. Taman Sari Kota Jakarta Barat,22,2,0,0,0,24
Kec. Cengkareng Kota Jakarta Barat,34,4,0,0,0,38
Kec. Kali Deres Kota Jakarta Barat,41,5,0,0,0,46
Kec. Jagakarsa Kota Jakarta Selatan,20,2,0,0,0,22
Kec. Pasar Minggu Kota Jakarta Selatan,16,2,0,0,0,18
Kec. Cilandak Kota Jakarta Selatan,22,4,0,0,0,26
Kec. Pesanggrahan Kota Jakarta Selatan,14,0,0,0,0,14
Kec. Kebayoran Lama Kota Jakarta Selatan,29,3,0,0,0,32
Kec. Kebayoran Baru Kota Jakarta Selatan,32,5,0,0,0,37
Kec. Mampang Prapatan Kota Jakarta Selatan,9,1,0,0,0,10
Kec. Pancoran Kota Jakarta Selatan,7,1,0,0,0,8
Kec. Tebet Kota Jakarta Selatan,21,1,0,0,0,22
Kec. Setia Budi Kota Jakarta Selatan,5,3,0,0,0,8
Kec. Pasar Rebo Kota Jakarta Timur,24,4,0,0,0,28
Kec. Ciracas Kota Jakarta Timur,20,2,0,0,0,22
Kec. Cipayung Kota Jakarta Timur,15,1,0,0,0,16
Kec. Makasar Kota Jakarta Timur,15,5,0,0,0,20
Kec. Kramat Jati Kota Jakarta Timur,18,4,0,0,0,22
Kec. Jatinegara Kota Jakarta Timur,17,3,0,0,0,20
Kec. Duren Sawit Kota Jakarta Timur,30,8,0,0,0,38
Kec. Cakung Kota Jakarta Timur,25,3,0,0,0,28
Kec. Pulo Gadung Kota Jakarta Timur,30,2,0,0,0,32
Kec. Matraman Kota Jakarta Timur,12,2,0,0,0,14
Kec. Jatinangor Kab. Sumedang,7,0,0,0,0,7
Kec. Cimanggung Kab. Sumedang,1,3,0,0,0,4
Kec. Tanjungsari Kab. Sumedang,6,0,0,0,0,6
Kec. Rancakalong Kab. Sumedang,1,1,0,0,0,2
Kec. Sumedang Selatan Kab. Sumedang,1,1,0,0,0,2
Kec. Sumedang Utara Kab. Sumedang,2,2,0,0,0,4
Kec. Situraja Kab. Sumedang,6,0,0,0,0,6
Kec. Darmaraja Kab. Sumedang,4,0,0,0,0,4
Kec. Tomo Kab. Sumedang,1,1,0,0,0,2
Kec. Conggeang Kab. Sumedang,2,0,0,0,0,2
Kec. Cimalaka Kab. Sumedang,1,3,0,0,0,4
Kec. Tanjungkerta Kab. Sumedang,1,1,0,0,0,2
Kec. Pamulihan Kab. Sumedang,0,0,0,0,0,0
Kec. Jatinunggal Kab. Sumedang,2,0,0,0,0,2
Kec. Bantarujeg Kab. Majalengka,6,0,0,0,0,6
Kec. Cikijing Kab. Majalengka,1,3,0,0,0,4
Kec. Talaga Kab. Majalengka,2,0,0,0,0,2
Kec. Maja Kab. Majalengka,0,0,0,0,0,0
Kec. Majalengka Kab. Majalengka,3,3,0,0,0,6
Kec. Sukahaji Kab. Majalengka,2,0,0,0,0,2
Kec. Rajagaluh Kab. Majalengka,5,1,0,0,0,6
Kec. Sindangwangi Kab. Majalengka,2,0,0,0,0,2
Kec. Leuwimunding Kab. Majalengka,2,0,0,0,0,2
Kec. Palasah Kab. Majalengka,2,0,0,0,0,2
Kec. Jatiwangi Kab. Majalengka,6,0,0,0,0,6
Kec. Dawuan Kab. Majalengka,0,0,0,0,0,0
Kec. Kadipaten Kab. Majalengka,2,0,0,0,0,2
Kec. Jatitujuh Kab. Majalengka,0,0,0,0,0,0
Kec. Ligung Kab. Majalengka,2,0,0,0,0,2
Kec. Sumberjaya Kab. Majalengka,2,0,0,0,0,2
Kec. Sindang Kab. Majalengka,2,0,0,0,0,2
Kec. Kasokandel Kab. Majalengka,4,0,0,0,0,4
Kec. Waled Kab. Cirebon,2,0,0,0,0,2
Kec. Ciledug Kab. Cirebon,4,0,0,0,0,4
Kec. Losari Kab. Cirebon,7,1,0,0,0,8
Kec. Babakan Kab. Cirebon,3,1,0,0,0,4
Kec. Karang Sembung Kab. Cirebon,0,0,0,0,0,0
Kec. Lemah Abang Kab. Cirebon,12,0,0,0,0,12
Kec. Astana Japura Kab. Cirebon,0,0,0,0,0,0
Kec. Beber Kab. Cirebon,6,2,0,0,0,8
Kec. Sumber Kab. Cirebon,4,0,0,0,0,4
Kec. Palimanan Kab. Cirebon,3,3,0,0,0,6
Kec. Plumbon Kab. Cirebon,1,1,0,0,0,2
Kec. Weru Kab. Cirebon,1,1,0,0,0,2
Kec. Kapetakan Kab. Cirebon,0,0,0,0,0,0
Kec. Klangenan Kab. Cirebon,0,0,0,0,0,0
Kec. Arjawinangun Kab. Cirebon,4,0,0,0,0,4
Kec. Ciwaringin Kab. Cirebon,1,1,0,0,0,2
Kec. Susukan Kab. Cirebon,1,1,0,0,0,2
Kec. Gegesik Kab. Cirebon,1,1,0,0,0,2
Kec. Pabedilan Kab. Cirebon,0,0,0,0,0,0
Kec. Dukupuntang Kab. Cirebon,1,2,0,0,0,3
Kec. Panguragan Kab. Cirebon,0,0,0,0,0,0
Kec. Kaliwedi Kab. Cirebon,0,0,0,0,0,0
Kec. Pangenan Kab. Cirebon,0,0,0,0,0,0
Kec. Kedawung Kab. Cirebon,5,1,0,0,0,6
Kec. Karangwareng Kab. Cirebon,2,0,0,0,0,2
Kec. Gunung Jati Kab. Cirebon,0,2,0,0,0,2
Kec. Tengah Tani Kab. Cirebon,1,1,0,0,0,2
Kec. Suranenggala Kab. Cirebon,4,0,0,0,0,4
Kec. Jamblang Kab. Cirebon,0,2,0,0,0,2
Kec. Kota Bogor Selatan Kota Bogor,13,3,0,0,0,16
Kec. Kota Bogor Timur Kota Bogor,11,1,0,0,0,12
Kec. Kota Bogor Utara Kota Bogor,13,0,0,0,0,13
Kec. Kota Bogor Tengah Kota Bogor,16,2,0,0,0,18
Kec. Kota Bogor Barat Kota Bogor,13,3,0,0,0,16
Kec. Tanah Sareal Kota Bogor,7,7,0,0,0,14
Kec. Baros Kota Sukabumi,0,0,0,0,0,0
Kec. Citamiang Kota Sukabumi,2,2,0,0,0,4
Kec. Warudoyong Kota Sukabumi,0,0,0,0,0,0
Kec. Gunung Puyuh Kota Sukabumi,7,1,0,0,0,8
Kec. Cikole Kota Sukabumi,15,3,0,0,0,18
Kec. Cibeureum Kota Sukabumi,1,1,0,0,0,2
Kec. Harjamukti Kota Cirebon,3,1,0,0,0,4
Kec. Lemahwungkuk Kota Cirebon,9,1,0,0,0,10
Kec. Kesambi Kota Cirebon,17,7,0,0,0,24
Kec. Kejaksan Kota Cirebon,9,3,0,0,0,12
Kec. Pondokgede Kota Bekasi,11,5,0,0,0,16
Kec. Jatiasih Kota Bekasi,15,6,0,0,0,21
Kec. Bantargebang Kota Bekasi,2,0,0,0,0,2
Kec. Bekasi Timur Kota Bekasi,13,11,0,0,0,24
Kec. Bekasi Selatan Kota Bekasi,27,3,0,0,0,30
Kec. Bekasi Barat Kota Bekasi,9,3,0,0,0,12
Kec. Bekasi Utara Kota Bekasi,17,3,0,0,0,20
Kec. Jati Sampurna Kota Bekasi,9,3,0,0,0,12
Kec. Medan Satria Kota Bekasi,12,6,0,0,0,18
Kec. Rawalumbu Kota Bekasi,11,5,0,0,0,16
Kec. Mustika Jaya Kota Bekasi,12,0,0,0,0,12
Kec. Pondok Melati Kota Bekasi,9,3,0,0,0,12
Kec. Sawangan Kota Depok,6,4,0,0,0,10
Kec. Pancoran Mas Kota Depok,16,7,0,0,0,23
Kec. Sukmajaya Kota Depok,13,3,0,0,0,16
Kec. Cimanggis Kota Depok,12,0,0,0,0,12
Kec. Beji Kota Depok,3,3,0,0,0,6
Kec. Limo Kota Depok,6,0,0,0,0,6
Kec. Cipayung Kota Depok,16,0,0,0,0,16
Kec. Cilodong Kota Depok,6,4,0,0,0,10
Kec. Cinere Kota Depok,4,0,0,0,0,4
Kec. Tapos Kota Depok,7,1,0,0,0,8
Kec. Bojongsari Kota Depok,6,2,0,0,0,8
Kec. Talegong Kab. Garut,2,0,0,0,0,2
Kec. Cisewu Kab. Garut,2,0,0,0,0,2
Kec. Bungbulang Kab. Garut,1,1,0,0,0,2
Kec. Pakenjeng Kab. Garut,2,0,0,0,0,2
Kec. Cikelet Kab. Garut,1,1,0,0,0,2
Kec. Pameungpeuk Kab. Garut,0,0,0,0,0,0
Kec. Cibalong Kab. Garut,1,1,0,0,0,2
Kec. Cisompet Kab. Garut,4,0,0,0,0,4
Kec. Peundeuy Kab. Garut,0,0,0,0,0,0
Kec. Singajaya Kab. Garut,4,0,0,0,0,4
Kec. Cikajang Kab. Garut,6,4,0,0,0,10
Kec. Banjarwangi Kab. Garut,0,0,0,0,0,0
Kec. Cilawu Kab. Garut,4,0,0,0,0,4
Kec. Bayongbong Kab. Garut,0,2,0,0,0,2
Kec. Cisurupan Kab. Garut,2,0,0,0,0,2
Kec. Samarang Kab. Garut,2,0,0,0,0,2
Kec. Garut Kota Kab. Garut,2,6,0,0,0,8
Kec. Karangpawitan Kab. Garut,2,2,0,0,0,4
Kec. Wanaraja Kab. Garut,0,0,0,0,0,0
Kec. Sukawening Kab. Garut,4,2,0,0,0,6
Kec. Banyuresmi Kab. Garut,2,2,0,0,0,4
Kec. Leles Kab. Garut,4,0,0,0,0,4
Kec. Leuwigoong Kab. Garut,1,1,0,0,0,2
Kec. Cibatu Kab. Garut,4,0,0,0,0,4
Kec. Cibiuk Kab. Garut,0,0,0,0,0,0
Kec. Kadungora Kab. Garut,4,4,0,0,0,8
Kec. Blubur Limbangan Kab. Garut,2,2,0,0,0,4
Kec. Selaawi Kab. Garut,0,0,0,0,0,0
Kec. Malangbong Kab. Garut,5,1,0,0,0,6
Kec. Mekarmukti Kab. Garut,0,0,0,0,0,0
Kec. Caringin Kab. Garut,0,0,0,0,0,0
Kec. Cihurip Kab. Garut,0,2,0,0,0,2
Kec. Sukaresmi Kab. Garut,0,0,0,0,0,0
Kec. Pasirwangi Kab. Garut,0,0,0,0,0,0
Kec. Karangtengah Kab. Garut,0,0,0,0,0,0
Kec. Kersamanah Kab. Garut,0,0,0,0,0,0
Kec. Tarogong Kaler Kab. Garut,2,2,0,0,0,4
Kec. Tarogong Kidul Kab. Garut,6,4,0,0,0,10
Kec. Cigedug Kab. Garut,0,0,0,0,0,0
Kec. Sucinaraja Kab. Garut,0,0,0,0,0,0
Kec. Haurgeulis Kab. Indramayu,1,1,0,0,0,2
Kec. Kroya Kab. Indramayu,2,0,0,0,0,2
Kec. Gabuswetan Kab. Indramayu,0,0,0,0,0,0
Kec. Lelea Kab. Indramayu,0,0,0,0,0,0
Kec. Bangodua Kab. Indramayu,0,0,0,0,0,0
Kec. Widasari Kab. Indramayu,0,0,0,0,0,0
Kec. Kertasemaya Kab. Indramayu,7,1,0,0,0,8
Kec. Krangkeng Kab. Indramayu,1,1,0,0,0,2
Kec. Karangampel Kab. Indramayu,5,1,0,0,0,6
Kec. Juntinyuat Kab. Indramayu,2,0,0,0,0,2
Kec. Sliyeg Kab. Indramayu,2,1,0,0,0,3
Kec. Jatibarang Kab. Indramayu,4,2,0,0,0,6
Kec. Balongan Kab. Indramayu,2,0,0,0,0,2
Kec. Indramayu Kab. Indramayu,6,4,0,0,0,10
Kec. Sindang Kab. Indramayu,3,1,0,0,0,4
Kec. Lohbener Kab. Indramayu,0,0,0,0,0,0
Kec. Losarang Kab. Indramayu,3,1,0,0,0,4
Kec. Kandanghaur Kab. Indramayu,6,2,0,0,0,8
Kec. Bongas Kab. Indramayu,2,0,0,0,0,2
Kec. Anjatan Kab. Indramayu,4,0,0,0,0,4
Kec. Sukra Kab. Indramayu,0,0,0,0,0,0
Kec. Arahan Kab. Indramayu,0,0,0,0,0,0
Kec. Cantigi Kab. Indramayu,2,0,0,0,0,2
Kec. Gantar Kab. Indramayu,0,0,0,0,0,0
Kec. Terisi Kab. Indramayu,1,1,0,0,0,2
Kec. Sukagumiwang Kab. Indramayu,2,0,0,0,0,2
Kec. Kedokan Bunder Kab. Indramayu,1,1,0,0,0,2
Kec. Pasekan Kab. Indramayu,1,0,0,0,0,1
Kec. Tukdana Kab. Indramayu,0,2,0,0,0,2
Kec. Patrol Kab. Indramayu,0,0,0,0,0,0
Kec. Sagalaherang Kab. Subang,2,0,0,0,0,2
Kec. Jalancagak Kab. Subang,5,1,0,0,0,6
Kec. Cisalak Kab. Subang,1,1,0,0,0,2
Kec. Tanjungsiang Kab. Subang,2,0,0,0,0,2
Kec. Cijambe Kab. Subang,0,2,0,0,0,2
Kec. Cibogo Kab. Subang,0,0,0,0,0,0
Kec. Subang Kab. Subang,9,5,0,0,0,14
Kec. Kalijati Kab. Subang,3,1,0,0,0,4
Kec. Cipeundeuy Kab. Subang,5,1,0,0,0,6
Kec. Pabuaran Kab. Subang,2,0,0,0,0,2
Kec. Patokbeusi Kab. Subang,1,1,0,0,0,2
Kec. Purwadadi Kab. Subang,4,2,0,0,0,6
Kec. Pagaden Kab. Subang,2,0,0,0,0,2
Kec. Compreng Kab. Subang,0,0,0,0,0,0
Kec. Binong Kab. Subang,2,0,0,0,0,2
Kec. Ciasem Kab. Subang,3,1,0,0,0,4
Kec. Pamanukan Kab. Subang,3,1,0,0,0,4
Kec. Pusakanagara Kab. Subang,1,1,0,0,0,2
Kec. Blanakan Kab. Subang,0,0,0,0,0,0
Kec. Serangpanjang Kab. Subang,0,0,0,0,0,0
Kec. Kasomalang Kab. Subang,0,0,0,0,0,0
Kec. Cimahi Selatan Kota Cimahi,11,1,0,0,0,12
Kec. Cimahi Tengah Kota Cimahi,20,1,0,0,0,21
Kec. Cimahi Utara Kota Cimahi,11,1,0,0,0,12
Kec. Cibeureum Kota Tasikmalaya,4,0,0,0,0,4
Kec. Tamansari Kota Tasikmalaya,3,1,0,0,0,4
Kec. Kawalu Kota Tasikmalaya,4,2,0,0,0,6
Kec. Mangkubumi Kota Tasikmalaya,1,0,0,0,0,1
Kec. Indihiang Kota Tasikmalaya,10,2,0,0,0,12
Kec. Cipedes Kota Tasikmalaya,2,0,0,0,0,2
Kec. Cihideung Kota Tasikmalaya,4,2,0,0,0,6
Kec. Tawang Kota Tasikmalaya,17,3,0,0,0,20
Kec. Purbaratu Kota Tasikmalaya,2,0,0,0,0,2
Kec. Bungursari Kota Tasikmalaya,8,0,0,0,0,8
Kec. Banjar Kota Banjar,4,2,0,0,0,6
Kec. Langensari Kota Banjar,3,1,0,0,0,4
Kec. Nanggung Kab. Bogor,1,1,0,0,0,2
Kec. Leuwiliang Kab. Bogor,6,4,0,0,0,10
Kec. Pamijahan Kab. Bogor,3,1,0,0,0,4
Kec. Cibungbulang Kab. Bogor,2,2,0,0,0,4
Kec. Ciampea Kab. Bogor,3,3,0,0,0,6
Kec. Dramaga Kab. Bogor,3,1,0,0,0,4
Kec. Ciomas Kab. Bogor,1,1,0,0,0,2
Kec. Cijeruk Kab. Bogor,0,0,0,0,0,0
Kec. Caringin Kab. Bogor,2,0,0,0,0,2
Kec. Ciawi Kab. Bogor,5,2,0,0,0,7
Kec. Cisarua Kab. Bogor,4,0,0,0,0,4
Kec. Megamendung Kab. Bogor,2,2,0,0,0,4
Kec. Sukaraja Kab. Bogor,4,0,0,0,0,4
Kec. Babakan Madang Kab. Bogor,8,6,0,0,0,14
Kec. Sukamakmur Kab. Bogor,3,3,0,0,0,6
Kec. Cariu Kab. Bogor,1,1,0,0,0,2
Kec. Jonggol Kab. Bogor,10,0,0,0,0,10
Kec. Cileungsi Kab. Bogor,8,4,0,0,0,12
Kec. Gunungputri Kab. Bogor,34,2,0,0,0,36
Kec. Citeureup Kab. Bogor,1,1,0,0,0,2
Kec. Cibinong Kab. Bogor,25,3,0,0,0,28
Kec. Bojong Gede Kab. Bogor,0,0,0,0,0,0
Kec. Kemang Kab. Bogor,9,3,0,0,0,12
Kec. Parung Kab. Bogor,6,2,0,0,0,8
Kec. Gunung Sindur Kab. Bogor,12,0,0,0,0,12
Kec. Rumpin Kab. Bogor,3,3,0,0,0,6
Kec. Cigudeg Kab. Bogor,2,0,0,0,0,2
Kec. Jasinga Kab. Bogor,2,0,0,0,0,2
Kec. Tenjo Kab. Bogor,2,2,0,0,0,4
Kec. Parungpanjang Kab. Bogor,3,1,0,0,0,4
Kec. Tamansari Kab. Bogor,4,2,0,0,0,6
Kec. Ciseeng Kab. Bogor,6,2,0,0,0,8
Kec. Klapanunggal Kab. Bogor,1,1,0,0,0,2
Kec. Sukajaya Kab. Bogor,2,0,0,0,0,2
Kec. Ranca Bungur Kab. Bogor,6,0,0,0,0,6
Kec. Tanjung Sari Kab. Bogor,0,0,0,0,0,0
Kec. Tajurhalang Kab. Bogor,3,3,0,0,0,6
Kec. Cigombong Kab. Bogor,8,0,0,0,0,8
Kec. Leuwisadeng Kab. Bogor,2,0,0,0,0,2
Kec. Tenjolaya Kab. Bogor,2,2,0,0,0,4
Kec. Ciwidey Kab. Bandung,3,1,0,0,0,4
Kec. Pasirjambu Kab. Bandung,0,2,0,0,0,2
Kec. Cimaung Kab. Bandung,2,0,0,0,0,2
Kec. Pangalengan Kab. Bandung,2,0,0,0,0,2
Kec. Kertasari Kab. Bandung,1,1,0,0,0,2
Kec. Pacet Kab. Bandung,0,0,0,0,0,0
Kec. Ibun Kab. Bandung,1,1,0,0,0,2
Kec. Paseh Kab. Bandung,3,3,0,0,0,6
Kec. Cikancung Kab. Bandung,0,0,0,0,0,0
Kec. Cicalengka Kab. Bandung,5,1,0,0,0,6
Kec. Rancaekek Kab. Bandung,5,1,0,0,0,6
Kec. Majalaya Kab. Bandung,3,1,0,0,0,4
Kec. Ciparay Kab. Bandung,14,0,0,0,0,14
Kec. Baleendah Kab. Bandung,6,6,0,0,0,12
Kec. Arjasari Kab. Bandung,8,0,0,0,0,8
Kec. Banjaran Kab. Bandung,11,3,0,0,0,14
Kec. Pameungpeuk Kab. Bandung,0,0,0,0,0,0
Kec. Katapang Kab. Bandung,1,1,0,0,0,2
Kec. Soreang Kab. Bandung,10,0,0,0,0,10
Kec. Margaasih Kab. Bandung,5,1,0,0,0,6
Kec. Margahayu Kab. Bandung,9,4,0,0,0,13
Kec. Dayeuhkolot Kab. Bandung,6,0,0,0,0,6
Kec. Bojongsoang Kab. Bandung,2,0,0,0,0,2
Kec. Cileunyi Kab. Bandung,4,2,0,0,0,6
Kec. Cilengkrang Kab. Bandung,0,0,0,0,0,0
Kec. Cimenyan Kab. Bandung,2,0,0,0,0,2
Kec. Rancabali Kab. Bandung,2,0,0,0,0,2
Kec. Nagreg Kab. Bandung,2,0,0,0,0,2
Kec. Solokanjeruk Kab. Bandung,1,1,0,0,0,2
Kec. Cangkuang Kab. Bandung,5,1,0,0,0,6
Kec. Kutawaringin Kab. Bandung,0,2,0,0,0,2
Kec. Darma Kab. Kuningan,1,1,0,0,0,2
Kec. Kadugede Kab. Kuningan,2,0,0,0,0,2
Kec. Ciniru Kab. Kuningan,0,0,0,0,0,0
Kec. Subang Kab. Kuningan,0,1,0,0,0,1
Kec. Ciwaru Kab. Kuningan,1,1,0,0,0,2
Kec. Cibingbin Kab. Kuningan,1,1,0,0,0,2
Kec. Luragung Kab. Kuningan,2,0,0,0,0,2
Kec. Cidahu Kab. Kuningan,2,0,0,0,0,2
Kec. Ciawigebang Kab. Kuningan,0,0,0,0,0,0
Kec. Lebakwangi Kab. Kuningan,2,0,0,0,0,2
Kec. Garawangi Kab. Kuningan,3,1,0,0,0,4
Kec. Kuningan Kab. Kuningan,6,0,0,0,0,6
Kec. Cigugur Kab. Kuningan,4,0,0,0,0,4
Kec. Jalaksana Kab. Kuningan,6,0,0,0,0,6
Kec. Cilimus Kab. Kuningan,4,0,0,0,0,4
Kec. Mandirancan Kab. Kuningan,2,0,0,0,0,2
Kec. Pasawahan Kab. Kuningan,2,0,0,0,0,2
Kec. Pancalang Kab. Kuningan,2,0,0,0,0,2
Kec. Cigandamekar Kab. Kuningan,5,1,0,0,0,6
Kec. Rongga Kab. Bandung Barat,0,0,0,0,0,0
Kec. Gununghalu Kab. Bandung Barat,0,0,0,0,0,0
Kec. Sindangkerta Kab. Bandung Barat,7,3,0,0,0,10
Kec. Cililin Kab. Bandung Barat,9,3,0,0,0,12
Kec. Cihampelas Kab. Bandung Barat,6,0,0,0,0,6
Kec. Cipongkor Kab. Bandung Barat,0,0,0,0,0,0
Kec. Batujajar Kab. Bandung Barat,4,0,0,0,0,4
Kec. Cipatat Kab. Bandung Barat,0,2,0,0,0,2
Kec. Padalarang Kab. Bandung Barat,10,0,0,0,0,10
Kec. Ngamprah Kab. Bandung Barat,6,2,0,0,0,8
Kec. Parongpong Kab. Bandung Barat,14,2,0,0,0,16
Kec. Lembang Kab. Bandung Barat,9,5,0,0,0,14
Kec. Cisarua Kab. Bandung Barat,3,1,0,0,0,4
Kec. Cikalongwetan Kab. Bandung Barat,3,1,0,0,0,4
Kec. Cipeundeuy Kab. Bandung Barat,7,1,0,0,0,8
Kec. Saguling Kab. Bandung Barat,2,0,0,0,0,2
KEC. CIMERAK Kab. Pangandaran,0,0,0,0,0,0
KEC. CIGUGUR Kab. Pangandaran,0,0,0,0,0,0
KEC. LANGKAPLANCAR Kab. Pangandaran,0,0,0,0,0,0
KEC. MANGUNJAYA Kab. Pangandaran,0,0,0,0,0,0
KEC. PADAHERANG Kab. Pangandaran,0,4,0,0,0,4
KEC. PANGANDARAN Kab. Pangandaran,2,2,0,0,0,4
KEC. PARIGI Kab. Pangandaran,2,0,0,0,0,2
Kec. Bandung Kulon Kota Bandung,2,4,0,0,0,6
Kec. Babakan Ciparay Kota Bandung,1,1,0,0,0,2
Kec. Bojong Loa Kaler Kota Bandung,10,0,0,0,0,10
Kec. Bojong Loa Kidul Kota Bandung,6,2,0,0,0,8
Kec. Astanaanyar Kota Bandung,4,0,0,0,0,4
Kec. Regol Kota Bandung,9,1,0,0,0,10
Kec. Lengkong Kota Bandung,14,8,0,0,0,22
Kec. Bandung Kidul Kota Bandung,2,0,0,0,0,2
Kec. Buahbatu Kota Bandung,4,2,0,0,0,6
Kec. Rancasari Kota Bandung,2,0,0,0,0,2
Kec. Cibiru Kota Bandung,4,4,0,0,0,8
Kec. Ujungberung Kota Bandung,4,2,0,0,0,6
Kec. Arcamanik Kota Bandung,6,0,0,0,0,6
Kec. Kiaracondong Kota Bandung,11,3,0,0,0,14
Kec. Sumur Bandung Kota Bandung,9,1,0,0,0,10
Kec. Andir Kota Bandung,21,7,0,0,0,28
Kec. Cicendo Kota Bandung,12,8,0,0,0,20
Kec. Bandung Wetan Kota Bandung,14,0,0,0,0,14
Kec. Cibeunying Kidul Kota Bandung,6,2,0,0,0,8
Kec. Cibeunying Kaler Kota Bandung,7,1,0,0,0,8
Kec. Coblong Kota Bandung,20,4,0,0,0,24
Kec. Sukajadi Kota Bandung,3,1,0,0,0,4
Kec. Sukasari Kota Bandung,8,0,0,0,0,8
Kec. Cidadap Kota Bandung,6,2,0,0,0,8
Kec. Gedebage Kota Bandung,1,1,0,0,0,2
Kec. Panyileukan Kota Bandung,1,3,0,0,0,4
Kec. Mandalajati Kota Bandung,2,2,0,0,0,4
Kec. Antapani Kota Bandung,1,1,0,0,0,2
Kec. Ciemas Kab. Sukabumi,0,0,0,0,0,0
Kec. Ciracap Kab. Sukabumi,0,0,0,0,0,0
Kec. Surade Kab. Sukabumi,0,0,0,0,0,0
Kec. Jampang Kulon Kab. Sukabumi,1,3,0,0,0,4
Kec. Kalibunder Kab. Sukabumi,0,0,0,0,0,0
Kec. Tegalbuleud Kab. Sukabumi,0,0,0,0,0,0
Kec. Cidolog Kab. Sukabumi,0,0,0,0,0,0
Kec. Sagaranten Kab. Sukabumi,1,1,0,0,0,2
Kec. Lengkong Kab. Sukabumi,0,0,0,0,0,0
Kec. Pelabuhan Ratu Kab. Sukabumi,2,6,0,0,0,8
Kec. Warung Kiara Kab. Sukabumi,0,0,0,0,0,0
Kec. Jampang Tengah Kab. Sukabumi,3,0,0,0,0,3
Kec. Cikembar Kab. Sukabumi,2,0,0,0,0,2
Kec. Nyalindung Kab. Sukabumi,0,2,0,0,0,2
Kec. Sukaraja Kab. Sukabumi,0,2,0,0,0,2
Kec. Sukabumi Kab. Sukabumi,0,0,0,0,0,0
Kec. Kadudampit Kab. Sukabumi,2,0,0,0,0,2
Kec. Cisaat Kab. Sukabumi,4,2,0,0,0,6
Kec. Cibadak Kab. Sukabumi,8,0,0,0,0,8
Kec. Nagrak Kab. Sukabumi,0,0,0,0,0,0
Kec. Cicurug Kab. Sukabumi,8,0,0,0,0,8
Kec. Cidahu Kab. Sukabumi,1,1,0,0,0,2
Kec. Parakansalak Kab. Sukabumi,3,1,0,0,0,4
Kec. Parungkuda Kab. Sukabumi,5,1,0,0,0,6
Kec. Kalapa Nunggal Kab. Sukabumi,0,2,0,0,0,2
Kec. Cikidang Kab. Sukabumi,3,1,0,0,0,4
Kec. Cisolok Kab. Sukabumi,3,1,0,0,0,4
Kec. Kabandungan Kab. Sukabumi,2,0,0,0,0,2
Kec. Gunung Guruh Kab. Sukabumi,4,0,0,0,0,4
Kec. Cikakak Kab. Sukabumi,1,1,0,0,0,2
Kec. Bantar Gadung Kab. Sukabumi,4,0,0,0,0,4
Kec. Cicantayan Kab. Sukabumi,6,0,0,0,0,6
Kec. Simpenan Kab. Sukabumi,5,1,0,0,0,6
Kec. Curugkembar Kab. Sukabumi,0,0,0,0,0,0
Kec. Purabaya Kab. Sukabumi,0,0,0,0,0,0
Kec. Cireunghas Kab. Sukabumi,0,0,0,0,0,0
Kec. Sukalarang Kab. Sukabumi,1,1,0,0,0,2
Kec. Caringin Kab. Sukabumi,2,0,0,0,0,2
Kec. Bojong Genteng Kab. Sukabumi,7,3,0,0,0,10
Kec. Ciambar Kab. Sukabumi,0,0,0,0,0,0
Kec. Cipatujah Kab. Tasikmalaya,0,0,0,0,0,0
Kec. Karangnunggal Kab. Tasikmalaya,1,0,0,0,0,1
Kec. Cikalong Kab. Tasikmalaya,1,1,0,0,0,2
Kec. Pancatengah Kab. Tasikmalaya,0,0,0,0,0,0
Kec. Cikatomas Kab. Tasikmalaya,0,2,0,0,0,2
Kec. Cibalong Kab. Tasikmalaya,0,2,0,0,0,2
Kec. Bantarkalong Kab. Tasikmalaya,2,0,0,0,0,2
Kec. Bojonggambir Kab. Tasikmalaya,0,0,0,0,0,0
Kec. Sodonghilir Kab. Tasikmalaya,1,1,0,0,0,2
Kec. Taraju Kab. Tasikmalaya,2,0,0,0,0,2
Kec. Salawu Kab. Tasikmalaya,7,3,0,0,0,10
Kec. Tanjungjaya Kab. Tasikmalaya,0,0,0,0,0,0
Kec. Sukaraja Kab. Tasikmalaya,0,0,0,0,0,0
Kec. Salopa Kab. Tasikmalaya,3,1,0,0,0,4
Kec. Cineam Kab. Tasikmalaya,0,0,0,0,0,0
Kec. Manonjaya Kab. Tasikmalaya,1,1,0,0,0,2
Kec. Singaparna Kab. Tasikmalaya,12,4,0,0,0,16
Kec. Cigalontang Kab. Tasikmalaya,1,1,0,0,0,2
Kec. Leuwisari Kab. Tasikmalaya,0,0,0,0,0,0
Kec. Cisayong Kab. Tasikmalaya,0,0,0,0,0,0
Kec. Rajapolah Kab. Tasikmalaya,2,2,0,0,0,4
Kec. Jamanis Kab. Tasikmalaya,0,0,0,0,0,0
Kec. Ciawi Kab. Tasikmalaya,0,2,0,0,0,2
Kec. Pagerageung Kab. Tasikmalaya,2,0,0,0,0,2
Kec. Sariwangi Kab. Tasikmalaya,1,1,0,0,0,2
Kec. Sukaratu Kab. Tasikmalaya,1,1,0,0,0,2
Kec. Sukarame Kab. Tasikmalaya,2,0,0,0,0,2
Kec. Bojongasih Kab. Tasikmalaya,0,0,0,0,0,0
Kec. Puspahiang Kab. Tasikmalaya,0,0,0,0,0,0
Kec. Jatiwaras Kab. Tasikmalaya,2,0,0,0,0,2
Kec. Mangunreja Kab. Tasikmalaya,1,1,0,0,0,2
Kec. Gunungtanjung Kab. Tasikmalaya,0,0,0,0,0,0
Kec. Padakembang Kab. Tasikmalaya,2,0,0,0,0,2
Kec. Sukahening Kab. Tasikmalaya,3,1,0,0,0,4
Kec. Jatiluhur Kab. Purwakarta,3,1,0,0,0,4
Kec. Maniis Kab. Purwakarta,2,0,0,0,0,2
Kec. Tegalwaru Kab. Purwakarta,0,0,0,0,0,0
Kec. Plered Kab. Purwakarta,2,0,0,0,0,2
Kec. Sukatani Kab. Purwakarta,0,2,0,0,0,2
Kec. Darangdan Kab. Purwakarta,0,0,2,0,0,2
Kec. Wanayasa Kab. Purwakarta,3,1,0,0,0,4
Kec. Pasawahan Kab. Purwakarta,3,0,0,0,0,3
Kec. Purwakarta Kab. Purwakarta,9,5,0,0,0,14
Kec. Campaka Kab. Purwakarta,1,1,0,0,0,2
Kec. Sukasari Kab. Purwakarta,0,0,0,0,0,0
Kec. Babakancikao Kab. Purwakarta,0,0,0,0,0,0
Kec. Cibatu Kab. Purwakarta,2,0,0,0,0,2
Kec. Bungursari Kab. Purwakarta,2,0,0,0,0,2
Kec. Pangkalan Kab. Karawang,2,0,0,0,0,2
Kec. Ciampel Kab. Karawang,4,0,0,0,0,4
Kec. Klari Kab. Karawang,0,2,0,0,0,2
Kec. Cikampek Kab. Karawang,3,1,0,0,0,4
Kec. Tirtamulya Kab. Karawang,0,0,0,0,0,0
Kec. Jatisari Kab. Karawang,1,3,0,0,0,4
Kec. Lemahabang Kab. Karawang,1,1,0,0,0,2
Kec. Telagasari Kab. Karawang,2,0,0,0,0,2
Kec. Rawamerta Kab. Karawang,2,0,0,0,0,2
Kec. Tempuran Kab. Karawang,2,0,0,0,0,2
Kec. Kutawaluya Kab. Karawang,1,1,0,0,0,2
Kec. Pedes Kab. Karawang,0,0,0,0,0,0
Kec. Cibuaya Kab. Karawang,0,0,0,0,0,0
Kec. Tirtajaya Kab. Karawang,0,0,0,0,0,0
Kec. Batujaya Kab. Karawang,4,0,0,0,0,4
Kec. Pakisjaya Kab. Karawang,0,0,0,0,0,0
Kec. Majalaya Kab. Karawang,0,2,0,0,0,2
Kec. Jayakerta Kab. Karawang,1,1,0,0,0,2
Kec. Banyusari Kab. Karawang,2,0,0,0,0,2
Kec. Kotabaru Kab. Karawang,3,1,0,0,0,4
Kec. Cilamaya Wetan Kab. Karawang,2,0,0,0,0,2
Kec. Teluk Jambe Barat Kab. Karawang,2,0,0,0,0,2
Kec. Teluk Jambe Timur Kab. Karawang,5,3,0,0,0,8
Kec. Karawang Timur Kab. Karawang,4,2,0,0,0,6
Kec. Tegalwaru Kab. Karawang,0,0,0,0,0,0
Kec. Karawang Barat Kab. Karawang,17,2,0,0,0,19
Kec. Agrabinta Kab. Cianjur,0,0,0,0,0,0
Kec. Sindang Barang Kab. Cianjur,2,0,0,0,0,2
Kec. Cidaun Kab. Cianjur,3,1,0,0,0,4
Kec. Naringgul Kab. Cianjur,2,0,0,0,0,2
Kec. Cibinong Kab. Cianjur,5,1,0,0,0,6
Kec. Kadupandak Kab. Cianjur,0,0,0,0,0,0
Kec. Takokak Kab. Cianjur,1,1,0,0,0,2
Kec. Sukanagara Kab. Cianjur,1,1,0,0,0,2
Kec. Pagelaran Kab. Cianjur,2,0,0,0,0,2
Kec. Cibeber Kab. Cianjur,1,1,0,0,0,2
Kec. Cilaku Kab. Cianjur,7,1,0,0,0,8
Kec. Sukaluyu Kab. Cianjur,2,0,0,0,0,2
Kec. Ciranjang Kab. Cianjur,9,1,0,0,0,10
Kec. Mande Kab. Cianjur,1,1,0,0,0,2
Kec. Karang Tengah Kab. Cianjur,4,2,0,0,0,6
Kec. Cianjur Kab. Cianjur,16,6,0,0,0,22
Kec. Cugenang Kab. Cianjur,3,1,0,0,0,4
Kec. Pacet Kab. Cianjur,6,2,0,0,0,8
Kec. Sukaresmi Kab. Cianjur,4,0,0,0,0,4
Kec. Cikalong Kulon Kab. Cianjur,3,1,0,0,0,4
Kec. Bojong Picung Kab. Cianjur,0,0,0,0,0,0
Kec. Cikadu Kab. Cianjur,0,0,0,0,0,0
Kec. Leles Kab. Cianjur,2,0,0,0,0,2
Kec. Cijati Kab. Cianjur,0,0,0,0,0,0
Kec. Gekbrong Kab. Cianjur,4,0,0,0,0,4
Kec. Cipanas Kab. Cianjur,5,1,0,0,0,6
Kec. Haurwangi Kab. Cianjur,0,0,0,0,0,0
Kec. Pasirkuda Kab. Cianjur,0,0,0,0,0,0
Kec. Banjarsari Kab. Ciamis,7,3,0,0,0,10
Kec. Lakbok Kab. Ciamis,2,0,0,0,0,2
Kec. Pamarican Kab. Ciamis,4,0,0,0,0,4
Kec. Cimaragas Kab. Ciamis,0,0,0,0,0,0
Kec. Cijeungjing Kab. Ciamis,1,1,0,0,0,2
Kec. Cisaga Kab. Ciamis,2,0,0,0,0,2
Kec. Rancah Kab. Ciamis,6,0,0,0,0,6
Kec. Rajadesa Kab. Ciamis,4,0,0,0,0,4
Kec. Sukadana Kab. Ciamis,1,1,0,0,0,2
Kec. Ciamis Kab. Ciamis,5,4,0,0,0,9
Kec. Cikoneng Kab. Ciamis,0,2,0,0,0,2
Kec. Cihaurbeuti Kab. Ciamis,0,2,0,0,0,2
Kec. Cipaku Kab. Ciamis,1,1,0,0,0,2
Kec. Jatinagara Kab. Ciamis,0,0,0,0,0,0
Kec. Panawangan Kab. Ciamis,4,0,0,0,0,4
Kec. Kawali Kab. Ciamis,1,1,0,0,0,2
Kec. Panjalu Kab. Ciamis,0,0,0,0,0,0
Kec. Sindangkasih Kab. Ciamis,2,0,0,0,0,2
Kec. Baregbeg Kab. Ciamis,2,0,0,0,0,2
Kec. Lumbung Kab. Ciamis,0,0,0,0,0,0
Kec. Setu Kab. Bekasi,2,2,0,0,0,4
Kec. Cibarusah Kab. Bekasi,11,1,0,0,0,12
Kec. Kedung Waringin Kab. Bekasi,4,0,0,0,0,4
Kec. Cibitung Kab. Bekasi,2,0,0,0,0,2
Kec. Babelan Kab. Bekasi,4,0,0,0,0,4
Kec. Taruma Jaya Kab. Bekasi,6,0,0,0,0,6
Kec. Tambelang Kab. Bekasi,1,1,0,0,0,2
Kec. Sukatani Kab. Bekasi,4,2,0,0,0,6
Kec. Pebayuran Kab. Bekasi,2,0,0,0,0,2
Kec. Cabangbungin Kab. Bekasi,5,1,0,0,0,6
Kec. Muara Gembong Kab. Bekasi,0,0,0,0,0,0
Kec. Tambun Selatan Kab. Bekasi,33,7,0,0,0,40
Kec. Tambun Utara Kab. Bekasi,6,0,0,0,0,6
Kec. Cikarang Barat Kab. Bekasi,12,6,0,0,0,18
Kec. Karang Bahagia Kab. Bekasi,0,0,0,0,0,0
Kec. Cikarang Utara Kab. Bekasi,15,7,0,0,0,22
Kec. Cikarang Selatan Kab. Bekasi,14,0,0,0,0,14
Kec. Cikarang Timur Kab. Bekasi,4,0,0,0,0,4
Kec. Bojong Mangu Kab. Bekasi,2,0,0,0,0,2
Kec. Cikarang Pusat Kab. Bekasi,4,2,0,0,0,6
Kec. Sukakarya Kab. Bekasi,0,0,0,0,0,0
Kec. Sukawangi Kab. Bekasi,1,1,0,0,0,2
Kec. Serang Baru Kab. Bekasi,2,2,0,0,0,4
Kec. Salaman Kab. Magelang,3,1,0,0,0,4
Kec. Borobudur Kab. Magelang,0,2,0,0,0,2
Kec. Ngluwar Kab. Magelang,1,3,0,0,0,4
Kec. Salam Kab. Magelang,0,0,0,0,0,0
Kec. Srumbung Kab. Magelang,2,0,0,0,0,2
Kec. Dukun Kab. Magelang,1,1,0,0,0,2
Kec. Muntilan Kab. Magelang,12,0,0,0,0,12
Kec. Mungkid Kab. Magelang,6,0,0,0,0,6
Kec. Sawangan Kab. Magelang,2,0,0,0,0,2
Kec. Candimulyo Kab. Magelang,6,0,0,0,0,6
Kec. Mertoyudan Kab. Magelang,6,2,0,0,0,8
Kec. Tempuran Kab. Magelang,0,0,0,0,0,0
Kec. Kaliangkrik Kab. Magelang,0,0,0,0,0,0
Kec. Bandongan Kab. Magelang,1,3,0,0,0,4
Kec. Secang Kab. Magelang,3,5,0,0,0,8
Kec. Tegalrejo Kab. Magelang,0,0,0,0,0,0
Kec. Pakis Kab. Magelang,1,1,0,0,0,2
Kec. Grabag Kab. Magelang,6,2,0,0,0,8
Kec. Sumber Kab. Rembang,1,1,0,0,0,2
Kec. Sale Kab. Rembang,4,2,0,0,0,6
Kec. Sarang Kab. Rembang,0,2,0,0,0,2
Kec. Pamotan Kab. Rembang,0,4,0,0,0,4
Kec. Sulang Kab. Rembang,2,2,0,0,0,4
Kec. Kaliori Kab. Rembang,3,3,0,0,0,6
Kec. Rembang Kab. Rembang,4,2,0,0,0,6
Kec. Kragan Kab. Rembang,3,0,0,0,0,3
Kec. Sluke Kab. Rembang,2,2,0,0,0,4
Kec. Lasem Kab. Rembang,3,1,0,0,0,4
Kec. Sukolilo Kab. Pati,2,0,0,0,0,2
Kec. Kayen Kab. Pati,8,4,0,0,0,12
Kec. Batangan Kab. Pati,2,0,0,0,0,2
Kec. Juwana Kab. Pati,4,0,0,0,0,4
Kec. Jakenan Kab. Pati,2,0,0,0,0,2
Kec. Pati Kab. Pati,20,2,0,0,0,22
Kec. Gabus Kab. Pati,1,1,0,0,0,2
Kec. Margorejo Kab. Pati,0,0,0,0,0,0
Kec. Gembong Kab. Pati,0,0,0,0,0,0
Kec. Wedarijaksa Kab. Pati,0,0,0,0,0,0
Kec. Margoyoso Kab. Pati,0,0,0,0,0,0
Kec. Tayu Kab. Pati,5,1,0,0,0,6
Kec. Dukuhseti Kab. Pati,2,0,0,0,0,2
Kec. Wonotunggal Kab. Batang,0,0,0,0,0,0
Kec. Bandar Kab. Batang,0,0,0,0,0,0
Kec. Bawang Kab. Batang,1,1,0,0,0,2
Kec. Tersono Kab. Batang,2,2,0,0,0,4
Kec. Gringsing Kab. Batang,2,0,0,0,0,2
Kec. Limpung Kab. Batang,2,0,0,0,0,2
Kec. Subah Kab. Batang,2,0,0,0,0,2
Kec. Batang Kab. Batang,10,0,0,0,0,10
Kec. Banyuputih Kab. Batang,2,0,0,0,0,2
Kec. Kandangserang Kab. Pekalongan,1,1,0,0,0,2
Kec. Paninggaran Kab. Pekalongan,1,1,0,0,0,2
Kec. Petungkriyono Kab. Pekalongan,1,1,0,0,0,2
Kec. Talun Kab. Pekalongan,1,1,0,0,0,2
Kec. Doro Kab. Pekalongan,4,0,0,0,0,4
Kec. Karanganyar Kab. Pekalongan,4,0,0,0,0,4
Kec. Kajen Kab. Pekalongan,4,0,0,0,0,4
Kec. Kesesi Kab. Pekalongan,2,0,0,0,0,2
Kec. Sragi Kab. Pekalongan,1,1,0,0,0,2
Kec. Bojong Kab. Pekalongan,2,0,0,0,0,2
Kec. Wonopringgo Kab. Pekalongan,1,1,0,0,0,2
Kec. Kedungwuni Kab. Pekalongan,3,3,0,0,0,6
Kec. Wiradesa Kab. Pekalongan,4,0,0,0,0,4
Kec. Purwareja Klampok Kab. Banjarnegara,4,0,0,0,0,4
Kec. Mandiraja Kab. Banjarnegara,4,0,0,0,0,4
Kec. Purwanegara Kab. Banjarnegara,0,0,0,0,0,0
Kec. Bawang Kab. Banjarnegara,1,1,0,0,0,2
Kec. Banjarnegara Kab. Banjarnegara,4,1,0,0,0,5
Kec. Sigaluh Kab. Banjarnegara,4,0,0,0,0,4
Kec. Wanadadi Kab. Banjarnegara,4,0,0,0,0,4
Kec. Karangkobar Kab. Banjarnegara,1,1,0,0,0,2
Kec. Batur Kab. Banjarnegara,1,1,0,0,0,2
Kec. Kalibening Kab. Banjarnegara,4,0,0,0,0,4
Kec. Weru Kab. Sukoharjo,0,2,0,0,0,2
Kec. Bulu Kab. Sukoharjo,0,4,0,0,0,4
Kec. Tawangsari Kab. Sukoharjo,4,2,0,0,0,6
Kec. Sukoharjo Kab. Sukoharjo,3,3,0,0,0,6
Kec. Nguter Kab. Sukoharjo,2,0,0,0,0,2
Kec. Bendosari Kab. Sukoharjo,3,1,0,0,0,4
Kec. Polokarto Kab. Sukoharjo,2,2,0,0,0,4
Kec. Mojolaban Kab. Sukoharjo,2,2,0,0,0,4
Kec. Grogol Kab. Sukoharjo,4,0,0,0,0,4
Kec. Baki Kab. Sukoharjo,6,0,0,0,0,6
Kec. Gatak Kab. Sukoharjo,0,0,0,0,0,0
Kec. Kartasura Kab. Sukoharjo,17,3,0,0,0,20
Kec. Kaliwungu Kab. Kudus,1,1,0,0,0,2
Kec. Kota Kudus Kab. Kudus,12,1,0,0,0,13
Kec. Jati Kab. Kudus,3,1,0,0,0,4
Kec. Mejobo Kab. Kudus,0,2,0,0,0,2
Kec. Jekulo Kab. Kudus,2,0,0,0,0,2
Kec. Bae Kab. Kudus,3,1,0,0,0,4
Kec. Gebog Kab. Kudus,1,1,0,0,0,2
Kec. Dawe Kab. Kudus,1,1,0,0,0,2
Kec. Pekalongan Barat Kota Pekalongan,4,0,0,0,0,4
Kec. Pekalongan Timur Kota Pekalongan,9,3,0,0,0,12
Kec. Pekalongan Selatan Kota Pekalongan,2,0,0,0,0,2
Kec. Pekalongan Utara Kota Pekalongan,5,2,0,0,0,7
Kec. Tegal Timur Kota Tegal,7,5,0,0,0,12
Kec. Tegal Barat Kota Tegal,11,1,0,0,0,12
Kec. Margadana Kota Tegal,2,0,0,0,0,2
Kec. Ampel Kab. Boyolali,3,1,0,0,0,4
Kec. Cepogo Kab. Boyolali,0,2,0,0,0,2
Kec. Musuk Kab. Boyolali,2,0,0,0,0,2
Kec. Boyolali Kab. Boyolali,10,4,0,0,0,14
Kec. Teras Kab. Boyolali,5,1,0,0,0,6
Kec. Banyudono Kab. Boyolali,2,0,0,0,0,2
Kec. Sambi Kab. Boyolali,3,3,0,0,0,6
Kec. Ngemplak Kab. Boyolali,3,1,0,0,0,4
Kec. Nogosari Kab. Boyolali,4,0,0,0,0,4
Kec. Simo Kab. Boyolali,4,0,0,0,0,4
Kec. Karanggede Kab. Boyolali,1,3,0,0,0,4
Kec. Klego Kab. Boyolali,2,1,0,0,0,3
Kec. Andong Kab. Boyolali,6,2,0,0,0,8
Kec. Kemusu Kab. Boyolali,2,0,0,0,0,2
Kec. Wonosegoro Kab. Boyolali,3,1,0,0,0,4
Kec. Juwangi Kab. Boyolali,1,1,0,0,0,2
Kec. Prambanan Kab. Klaten,0,2,0,0,0,2
Kec. Gantiwarno Kab. Klaten,3,1,0,0,0,4
Kec. Wedi Kab. Klaten,3,1,0,0,0,4
Kec. Bayat Kab. Klaten,1,1,0,0,0,2
Kec. Cawas Kab. Klaten,1,1,0,0,0,2
Kec. Jogonalan Kab. Klaten,0,0,0,0,0,0
Kec. Karangnongko Kab. Klaten,1,1,0,0,0,2
Kec. Ngawen Kab. Klaten,2,0,0,0,0,2
Kec. Ceper Kab. Klaten,2,0,0,0,0,2
Kec. Pedan Kab. Klaten,1,1,0,0,0,2
Kec. Karangdowo Kab. Klaten,1,1,0,0,0,2
Kec. Juwiring Kab. Klaten,0,0,0,0,0,0
Kec. Wonosari Kab. Klaten,2,0,0,0,0,2
Kec. Delanggu Kab. Klaten,1,1,0,0,0,2
Kec. Polanharjo Kab. Klaten,1,1,0,0,0,2
Kec. Karanganom Kab. Klaten,0,0,0,0,0,0
Kec. Jatinom Kab. Klaten,2,0,0,0,0,2
Kec. Klaten Selatan Kab. Klaten,8,2,0,0,0,10
Kec. Klaten Tengah Kab. Klaten,4,0,0,0,0,4
Kec. Klaten Utara Kab. Klaten,15,1,0,0,0,16
Kec. Magelang Selatan Kota Magelang,14,0,0,0,0,14
Kec. Magelang Utara Kota Magelang,6,0,0,0,0,6
Kec. Magelang Tengah Kota Magelang,7,5,0,0,0,12
Kec. Laweyan Kota Surakarta,23,1,0,0,0,24
Kec. Serengan Kota Surakarta,1,1,0,0,0,2
Kec. Pasarkliwon Kota Surakarta,6,2,0,0,0,8
Kec. Jebres Kota Surakarta,11,3,0,0,0,14
Kec. Banjarsari Kota Surakarta,25,2,0,0,0,27
Kec. Argomulyo Kota Salatiga,0,1,0,0,0,1
Kec. Sidomukti Kota Salatiga,4,0,0,0,0,4
Kec. Sidorejo Kota Salatiga,10,2,0,0,0,12
Kec. Mijen Kota Semarang,13,1,0,0,0,14
Kec. Gunung Pati Kota Semarang,9,1,0,0,0,10
Kec. Banyumanik Kota Semarang,19,1,0,0,0,20
Kec. Gajah Mungkur Kota Semarang,10,2,0,0,0,12
Kec. Semarang Selatan Kota Semarang,22,4,0,0,0,26
Kec. Candisari Kota Semarang,5,1,0,0,0,6
Kec. Tembalang Kota Semarang,0,0,0,0,0,0
Kec. Pedurungan Kota Semarang,7,3,0,0,0,10
Kec. Genuk Kota Semarang,6,2,0,0,0,8
Kec. Gayamsari Kota Semarang,7,1,0,0,0,8
Kec. Semarang Timur Kota Semarang,6,2,0,0,0,8
Kec. Semarang Tengah Kota Semarang,26,3,0,0,0,29
Kec. Semarang Utara Kota Semarang,10,4,0,0,0,14
Kec. Semarang Barat Kota Semarang,35,1,0,0,0,36
Kec. Tugu Kota Semarang,0,0,0,0,0,0
Kec. Ngaliyan Kota Semarang,8,0,0,0,0,8
Kec. Dayeuhluhur Kab. Cilacap,0,6,0,0,0,6
Kec. Majenang Kab. Cilacap,10,0,0,0,0,10
Kec. Cimanggu Kab. Cilacap,1,1,0,0,0,2
Kec. Karangpucung Kab. Cilacap,1,1,0,0,0,2
Kec. Cipari Kab. Cilacap,3,1,0,0,0,4
Kec. Sidareja Kab. Cilacap,4,4,0,0,0,8
Kec. Kedungreja Kab. Cilacap,3,1,0,0,0,4
Kec. Patimuan Kab. Cilacap,2,2,0,0,0,4
Kec. Gandrungmangu Kab. Cilacap,2,0,0,0,0,2
Kec. Bantarsari Kab. Cilacap,1,1,0,0,0,2
Kec. Kawunganten Kab. Cilacap,2,0,0,0,0,2
Kec. Kampung Laut Kab. Cilacap,0,0,0,0,0,0
Kec. Jeruklegi Kab. Cilacap,2,0,0,0,0,2
Kec. Kesugihan Kab. Cilacap,0,0,0,0,0,0
Kec. Adipala Kab. Cilacap,4,0,0,0,0,4
Kec. Maos Kab. Cilacap,6,0,0,0,0,6
Kec. Sampang Kab. Cilacap,3,5,0,0,0,8
Kec. Kroya Kab. Cilacap,10,0,0,0,0,10
Kec. Binangun Kab. Cilacap,2,2,0,0,0,4
Kec. Cilacap Selatan Kab. Cilacap,6,2,0,0,0,8
Kec. Cilacap Tengah Kab. Cilacap,5,3,0,0,0,8
Kec. Cilacap Utara Kab. Cilacap,0,2,0,0,0,2
Kec. Moga Kab. Pemalang,5,1,0,0,0,6
Kec. Belik Kab. Pemalang,3,3,0,0,0,6
Kec. Bodeh Kab. Pemalang,2,0,0,0,0,2
Kec. Bantarbolang Kab. Pemalang,0,2,0,0,0,2
Kec. Randudongkal Kab. Pemalang,1,1,0,0,0,2
Kec. Pemalang Kab. Pemalang,8,2,0,0,0,10
Kec. Taman Kab. Pemalang,3,1,0,0,0,4
Kec. Petarukan Kab. Pemalang,4,2,0,0,0,6
Kec. Comal Kab. Pemalang,5,1,0,0,0,6
Kec. Ulujami Kab. Pemalang,2,0,0,0,0,2
Kec. Wangon Kab. Banyumas,0,2,0,0,0,2
Kec. Jatilawang Kab. Banyumas,6,0,0,0,0,6
Kec. Rawalo Kab. Banyumas,2,0,0,0,0,2
Kec. Kebasen Kab. Banyumas,0,2,0,0,0,2
Kec. Kemranjen Kab. Banyumas,0,0,0,0,0,0
Kec. Sumpiuh Kab. Banyumas,0,2,0,0,0,2
Kec. Tambak Kab. Banyumas,3,1,0,0,0,4
Kec. Banyumas Kab. Banyumas,2,2,0,0,0,4
Kec. Patikraja Kab. Banyumas,1,1,0,0,0,2
Kec. Ajibarang Kab. Banyumas,3,1,0,0,0,4
Kec. Gumelar Kab. Banyumas,4,2,0,0,0,6
Kec. Cilongok Kab. Banyumas,4,0,0,0,0,4
Kec. Karanglewas Kab. Banyumas,0,0,0,0,0,0
Kec. Kedung Banteng Kab. Banyumas,2,0,0,0,0,2
Kec. Baturaden Kab. Banyumas,1,1,0,0,0,2
Kec. Sokaraja Kab. Banyumas,10,4,0,0,0,14
Kec. Purwokerto Selatan Kab. Banyumas,6,0,0,0,0,6
Kec. Purwokerto Barat Kab. Banyumas,2,0,0,0,0,2
Kec. Purwokerto Timur Kab. Banyumas,22,8,0,0,0,30
Kec. Purwokerto Utara Kab. Banyumas,1,1,0,0,0,2
Kec. Kemangkon Kab. Purbalingga,2,0,0,0,0,2
Kec. Bukateja Kab. Purbalingga,2,0,0,0,0,2
Kec. Kejobong Kab. Purbalingga,1,2,0,0,0,3
Kec. Purbalingga Kab. Purbalingga,9,1,0,0,0,10
Kec. Kalimanah Kab. Purbalingga,1,1,0,0,0,2
Kec. Padamara Kab. Purbalingga,1,1,0,0,0,2
Kec. Kutasari Kab. Purbalingga,2,0,0,0,0,2
Kec. Bobotsari Kab. Purbalingga,1,3,0,0,0,4
Kec. Karangreja Kab. Purbalingga,4,0,0,0,0,4
Kec. Karanganyar Kab. Purbalingga,0,0,0,0,0,0
Kec. Karangmoncol Kab. Purbalingga,2,0,0,0,0,2
Kec. Rembang Kab. Purbalingga,1,1,0,0,0,2
Kec. Kertanegara Kab. Purbalingga,1,1,0,0,0,2
Kec. Margasari Kab. Tegal,3,1,0,0,0,4
Kec. Bojong Kab. Tegal,1,1,0,0,0,2
Kec. Balapulang Kab. Tegal,2,0,0,0,0,2
Kec. Pagerbarang Kab. Tegal,2,0,0,0,0,2
Kec. Lebaksiu Kab. Tegal,2,0,0,0,0,2
Kec. Jatinegara Kab. Tegal,2,2,0,0,0,4
Kec. Pangkah Kab. Tegal,4,0,0,0,0,4
Kec. Slawi Kab. Tegal,11,1,0,0,0,12
Kec. Dukuhwaru Kab. Tegal,0,2,0,0,0,2
Kec. Adiwerna Kab. Tegal,2,2,0,0,0,4
Kec. Talang Kab. Tegal,1,1,0,0,0,2
Kec. Tarub Kab. Tegal,0,0,0,0,0,0
Kec. Kramat Kab. Tegal,2,0,0,0,0,2
Kec. Suradadi Kab. Tegal,3,1,0,0,0,4
Kec. Warureja Kab. Tegal,3,1,0,0,0,4
Kec. Salem Kab. Brebes,2,0,0,0,0,2
Kec. Bantarkawung Kab. Brebes,2,0,0,0,0,2
Kec. Bumiayu Kab. Brebes,8,2,0,0,0,10
Kec. Paguyangan Kab. Brebes,2,2,0,0,0,4
Kec. Sirampog Kab. Brebes,2,2,0,0,0,4
Kec. Tonjong Kab. Brebes,3,1,0,0,0,4
Kec. Larangan Kab. Brebes,6,0,0,0,0,6
Kec. Ketanggungan Kab. Brebes,3,1,0,0,0,4
Kec. Banjarharjo Kab. Brebes,4,0,0,0,0,4
Kec. Losari Kab. Brebes,1,1,0,0,0,2
Kec. Tanjung Kab. Brebes,2,0,0,0,0,2
Kec. Kersana Kab. Brebes,1,1,0,0,0,2
Kec. Bulakamba Kab. Brebes,1,3,0,0,0,4
Kec. Wanasari Kab. Brebes,2,0,0,0,0,2
Kec. Songgom Kab. Brebes,4,0,0,0,0,4
Kec. Jatibarang Kab. Brebes,2,0,0,0,0,2
Kec. Brebes Kab. Brebes,6,2,0,0,0,8
Kec. Wadaslintang Kab. Wonosobo,3,1,0,0,0,4
Kec. Kepil Kab. Wonosobo,0,2,0,0,0,2
Kec. Sapuran Kab. Wonosobo,2,0,0,0,0,2
Kec. Kaliwiro Kab. Wonosobo,2,0,0,0,0,2
Kec. Leksono Kab. Wonosobo,1,1,0,0,0,2
Kec. Selomerto Kab. Wonosobo,1,1,0,0,0,2
Kec. Kertek Kab. Wonosobo,2,0,0,0,0,2
Kec. Wonosobo Kab. Wonosobo,3,3,0,0,0,6
Kec. Watumalang Kab. Wonosobo,0,0,0,0,0,0
Kec. Mojotengah Kab. Wonosobo,3,2,0,0,0,5
Kec. Kejajar Kab. Wonosobo,1,1,0,0,0,2
Kec. Jati Kab. Blora,2,0,0,0,0,2
Kec. Randublatung Kab. Blora,8,0,0,0,0,8
Kec. Kradenan Kab. Blora,1,1,0,0,0,2
Kec. Kedungtuban Kab. Blora,5,1,0,0,0,6
Kec. Cepu Kab. Blora,7,5,0,0,0,12
Kec. Jiken Kab. Blora,0,0,0,0,0,0
Kec. Jepon Kab. Blora,3,1,0,0,0,4
Kec. Kota Blora Kab. Blora,10,2,0,0,0,12
Kec. Tunjungan Kab. Blora,2,0,0,0,0,2
Kec. Ngawen Kab. Blora,4,0,0,0,0,4
Kec. Todanan Kab. Blora,2,0,0,0,0,2
Kec. Plantungan Kab. Kendal,0,0,0,0,0,0
Kec. Sukorejo Kab. Kendal,4,0,0,0,0,4
Kec. Patean Kab. Kendal,2,0,0,0,0,2
Kec. Singorojo Kab. Kendal,0,2,0,0,0,2
Kec. Limbangan Kab. Kendal,2,0,0,0,0,2
Kec. Boja Kab. Kendal,5,1,0,0,0,6
Kec. Kaliwungu Kab. Kendal,3,1,0,0,0,4
Kec. Brangsong Kab. Kendal,4,0,0,0,0,4
Kec. Pegandon Kab. Kendal,1,1,0,0,0,2
Kec. Gemuh Kab. Kendal,1,1,0,0,0,2
Kec. Weleri Kab. Kendal,6,2,0,0,0,8
Kec. Rowosari Kab. Kendal,2,2,0,0,0,4
Kec. Kangkung Kab. Kendal,0,0,0,0,0,0
Kec. Cepiring Kab. Kendal,1,1,0,0,0,2
Kec. Patebon Kab. Kendal,5,1,0,0,0,6
Kec. Kota Kendal Kab. Kendal,6,2,0,0,0,8
Kec. Kaliwungu Selatan Kab. Kendal,2,0,0,0,0,2
Kec. Ayah Kab. Kebumen,0,0,0,0,0,0
Kec. Petanahan Kab. Kebumen,1,1,0,0,0,2
Kec. Klirong Kab. Kebumen,1,1,0,0,0,2
Kec. Buluspesantren Kab. Kebumen,2,0,0,0,0,2
Kec. Mirit Kab. Kebumen,0,4,0,0,0,4
Kec. Prembun Kab. Kebumen,6,0,0,0,0,6
Kec. Kutowinangun Kab. Kebumen,4,0,0,0,0,4
Kec. Kebumen Kab. Kebumen,4,2,0,0,0,6
Kec. Pejagoan Kab. Kebumen,3,3,0,0,0,6
Kec. Sruweng Kab. Kebumen,3,1,0,0,0,4
Kec. Rowokele Kab. Kebumen,2,0,0,0,0,2
Kec. Gombong Kab. Kebumen,12,3,0,0,0,15
Kec. Karanganyar Kab. Kebumen,2,0,0,0,0,2
Kec. Karangsambung Kab. Kebumen,0,0,0,0,0,0
Kec. Pracimantoro Kab. Wonogiri,0,0,0,0,0,0
Kec. Paranggupito Kab. Wonogiri,0,2,0,0,0,2
Kec. Giriwoyo Kab. Wonogiri,0,4,0,0,0,4
Kec. Tirtomoyo Kab. Wonogiri,6,0,0,0,0,6
Kec. Nguntoronadi Kab. Wonogiri,2,0,0,0,0,2
Kec. Baturetno Kab. Wonogiri,2,2,0,0,0,4
Kec. Wuryantoro Kab. Wonogiri,1,1,0,0,0,2
Kec. Manyaran Kab. Wonogiri,2,2,0,0,0,4
Kec. Wonogiri Kab. Wonogiri,6,1,0,0,0,7
Kec. Sidoharjo Kab. Wonogiri,1,1,0,0,0,2
Kec. Purwantoro Kab. Wonogiri,2,0,0,0,0,2
Kec. Slogohimo Kab. Wonogiri,2,0,0,0,0,2
Kec. Jatisrono Kab. Wonogiri,0,2,0,0,0,2
Kec. Girimarto Kab. Wonogiri,4,0,0,0,0,4
Kec. Jumapolo Kab. Karanganyar,0,0,0,0,0,0
Kec. Jumantono Kab. Karanganyar,0,0,0,0,0,0
Kec. Karangpandan Kab. Karanganyar,5,3,0,0,0,8
Kec. Karanganyar Kab. Karanganyar,9,1,0,0,0,10
Kec. Jaten Kab. Karanganyar,4,0,0,0,0,4
Kec. Colomadu Kab. Karanganyar,2,2,0,0,0,4
Kec. Gondangrejo Kab. Karanganyar,2,2,0,0,0,4
Kec. Kebakkramat Kab. Karanganyar,2,0,0,0,0,2
Kec. Mojogedang Kab. Karanganyar,2,0,0,0,0,2
Kec. Kerjo Kab. Karanganyar,0,2,0,0,0,2
Kec. Jenawi Kab. Karanganyar,0,0,0,0,0,0
Kec. Kedung Kab. Jepara,0,0,0,0,0,0
Kec. Pecangaan Kab. Jepara,2,2,0,0,0,4
Kec. Welahan Kab. Jepara,1,1,0,0,0,2
Kec. Mayong Kab. Jepara,4,2,0,0,0,6
Kec. Nalumsari Kab. Jepara,2,0,0,0,0,2
Kec. Batealit Kab. Jepara,0,0,0,0,0,0
Kec. Tahunan Kab. Jepara,2,0,0,0,0,2
Kec. Jepara Kab. Jepara,6,2,0,0,0,8
Kec. Mlonggo Kab. Jepara,1,1,0,0,0,2
Kec. Bangsri Kab. Jepara,4,0,0,0,0,4
Kec. Keling Kab. Jepara,0,0,0,0,0,0
Kec. Kalinyamatan Kab. Jepara,2,0,0,0,0,2
Kec. Kembang Kab. Jepara,1,1,0,0,0,2
Kec. Donorojo Kab. Jepara,2,0,0,0,0,2
Kec. Mranggen Kab. Demak,5,5,0,0,0,10
Kec. Karangawen Kab. Demak,2,0,0,0,0,2
Kec. Guntur Kab. Demak,1,1,0,0,0,2
Kec. Sayung Kab. Demak,3,1,0,0,0,4
Kec. Karang Tengah Kab. Demak,4,2,0,0,0,6
Kec. Bonang Kab. Demak,2,0,0,0,0,2
Kec. Demak Kab. Demak,12,2,0,0,0,14
Kec. Wonosalam Kab. Demak,3,1,0,0,0,4
Kec. Dempet Kab. Demak,2,0,0,0,0,2
Kec. Gajah Kab. Demak,0,0,0,0,0,0
Kec. Karanganyar Kab. Demak,2,0,0,0,0,2
Kec. Mijen Kab. Demak,1,1,0,0,0,2
Kec. Wedung Kab. Demak,7,1,0,0,0,8
Kec. Grabag Kab. Purworejo,4,0,0,0,0,4
Kec. Purwodadi Kab. Purworejo,6,2,0,0,0,8
Kec. Kaligesing Kab. Purworejo,0,2,0,0,0,2
Kec. Purworejo Kab. Purworejo,10,2,0,0,0,12
Kec. Banyu Urip Kab. Purworejo,2,0,0,0,0,2
Kec. Bayan Kab. Purworejo,0,0,0,0,0,0
Kec. Kutoarjo Kab. Purworejo,9,1,0,0,0,10
Kec. Butuh Kab. Purworejo,4,0,0,0,0,4
Kec. Pituruh Kab. Purworejo,5,1,0,0,0,6
Kec. Kemiri Kab. Purworejo,2,0,0,0,0,2
Kec. Bruno Kab. Purworejo,4,0,0,0,0,4
Kec. Gebang Kab. Purworejo,2,0,0,0,0,2
Kec. Loano Kab. Purworejo,1,1,0,0,0,2
Kec. Kalijambe Kab. Sragen,3,1,0,0,0,4
Kec. Plupuh Kab. Sragen,0,0,0,0,0,0
Kec. Masaran Kab. Sragen,1,1,0,0,0,2
Kec. Sambirejo Kab. Sragen,0,0,0,0,0,0
Kec. Gondang Kab. Sragen,4,0,0,0,0,4
Kec. Sambung Macan Kab. Sragen,2,0,0,0,0,2
Kec. Karangmalang Kab. Sragen,2,4,0,0,0,6
Kec. Sragen Kab. Sragen,6,4,0,0,0,10
Kec. Gemolong Kab. Sragen,6,1,0,0,0,7
Kec. Sumberlawang Kab. Sragen,1,1,0,0,0,2
Kec. Sukodono Kab. Sragen,2,0,0,0,0,2
Kec. Tangen Kab. Sragen,2,0,0,0,0,2
Kec. Kedungjati Kab. Grobogan,1,1,0,0,0,2
Kec. Karangrayung Kab. Grobogan,1,2,0,0,0,3
Kec. Penawangan Kab. Grobogan,0,0,0,0,0,0
Kec. Toroh Kab. Grobogan,2,0,0,0,0,2
Kec. Geyer Kab. Grobogan,2,0,0,0,0,2
Kec. Pulokulon Kab. Grobogan,4,0,0,0,0,4
Kec. Kradenan Kab. Grobogan,2,2,0,0,0,4
Kec. Gabus Kab. Grobogan,2,0,0,0,0,2
Kec. Wirosari Kab. Grobogan,4,3,0,0,0,7
Kec. Tawangharjo Kab. Grobogan,0,0,0,0,0,0
Kec. Grobogan Kab. Grobogan,1,1,0,0,0,2
Kec. Purwodadi Kab. Grobogan,6,4,0,0,0,10
Kec. Godong Kab. Grobogan,4,4,0,0,0,8
Kec. Gubug Kab. Grobogan,3,1,0,0,0,4
Kec. Tanggungharjo Kab. Grobogan,1,3,0,0,0,4
Kec. Getasan Kab. Semarang,0,4,0,0,0,4
Kec. Tengaran Kab. Semarang,6,0,0,0,0,6
Kec. Susukan Kab. Semarang,3,5,0,0,0,8
Kec. Suruh Kab. Semarang,4,0,0,0,0,4
Kec. Pabelan Kab. Semarang,0,2,0,0,0,2
Kec. Tuntang Kab. Semarang,2,2,0,0,0,4
Kec. Banyubiru Kab. Semarang,2,0,0,0,0,2
Kec. Jambu Kab. Semarang,1,3,0,0,0,4
Kec. Sumowono Kab. Semarang,1,1,0,0,0,2
Kec. Ambarawa Kab. Semarang,8,0,0,0,0,8
Kec. Bawen Kab. Semarang,2,0,0,0,0,2
Kec. Bringin Kab. Semarang,6,6,0,0,0,12
Kec. Bergas Kab. Semarang,1,1,0,0,0,2
Kec. Kaliwungu Kab. Semarang,1,1,0,0,0,2
Kec. Ungaran Barat Kab. Semarang,2,2,0,0,0,4
Kec. Ungaran Timur Kab. Semarang,0,0,0,0,0,0
Kec. Bandungan Kab. Semarang,1,1,0,0,0,2
Kec. Parakan Kab. Temanggung,0,0,0,0,0,0
Kec. Temanggung Kab. Temanggung,6,6,0,0,0,12
Kec. Tembarak Kab. Temanggung,1,1,0,0,0,2
Kec. Pringsurat Kab. Temanggung,3,1,0,0,0,4
Kec. Kaloran Kab. Temanggung,2,0,0,0,0,2
Kec. Kandangan Kab. Temanggung,0,2,0,0,0,2
Kec. Kedu Kab. Temanggung,2,0,0,0,0,2
Kec. Candiroto Kab. Temanggung,2,0,0,0,0,2
Kec. Srandakan Kab. Bantul,2,0,0,0,0,2
Kec. Sanden Kab. Bantul,2,0,0,0,0,2
Kec. Kretek Kab. Bantul,3,1,0,0,0,4
Kec. Pundong Kab. Bantul,2,0,0,0,0,2
Kec. Bambang Lipuro Kab. Bantul,2,4,0,0,0,6
Kec. Bantul Kab. Bantul,9,3,0,0,0,12
Kec. Jetis Kab. Bantul,4,0,0,0,0,4
Kec. Imogiri Kab. Bantul,6,0,0,0,0,6
Kec. Dlingo Kab. Bantul,0,0,0,0,0,0
Kec. Pleret Kab. Bantul,2,2,0,0,0,4
Kec. Piyungan Kab. Bantul,4,0,0,0,0,4
Kec. Banguntapan Kab. Bantul,11,1,0,0,0,12
Kec. Sewon Kab. Bantul,5,3,0,0,0,8
Kec. Kasihan Kab. Bantul,3,3,0,0,0,6
Kec. Pajangan Kab. Bantul,2,0,0,0,0,2
Kec. Sedayu Kab. Bantul,9,5,0,0,0,14
Kec. Moyudan Kab. Sleman,2,0,0,0,0,2
Kec. Minggir Kab. Sleman,4,0,0,0,0,4
Kec. Seyegan Kab. Sleman,2,2,0,0,0,4
Kec. Godean Kab. Sleman,2,0,0,0,0,2
Kec. Mlati Kab. Sleman,11,3,0,0,0,14
Kec. Depok Kab. Sleman,10,8,0,0,0,18
Kec. Berbah Kab. Sleman,2,0,0,0,0,2
Kec. Prambanan Kab. Sleman,9,3,0,0,0,12
Kec. Kalasan Kab. Sleman,2,4,0,0,0,6
Kec. Ngemplak Kab. Sleman,3,5,0,0,0,8
Kec. Ngaglik Kab. Sleman,2,2,0,0,0,4
Kec. Sleman Kab. Sleman,4,4,0,0,0,8
Kec. Tempel Kab. Sleman,4,2,0,0,0,6
Kec. Turi Kab. Sleman,0,2,0,0,0,2
Kec. Pakem Kab. Sleman,8,2,0,0,0,10
Kec. Cangkringan Kab. Sleman,2,2,0,0,0,4
Kec. Gamping Kab. Sleman,3,3,0,0,0,6
Kec. Panggang Kab. Gunung Kidul,4,0,0,0,0,4
Kec. Rongkop Kab. Gunung Kidul,2,0,0,0,0,2
Kec. Semanu Kab. Gunung Kidul,2,4,0,0,0,6
Kec. Ponjong Kab. Gunung Kidul,2,4,0,0,0,6
Kec. Karangmojo Kab. Gunung Kidul,4,0,0,0,0,4
Kec. Wonosari Kab. Gunung Kidul,11,3,0,0,0,14
Kec. Playen Kab. Gunung Kidul,2,6,0,0,0,8
Kec. Patuk Kab. Gunung Kidul,2,0,0,0,0,2
Kec. Nglipar Kab. Gunung Kidul,0,0,0,0,0,0
Kec. Ngawen Kab. Gunung Kidul,1,1,0,0,0,2
Kec. Semin Kab. Gunung Kidul,3,1,0,0,0,4
Kec. Tanjungsari Kab. Gunung Kidul,1,1,0,0,0,2
Kec. Temon Kab. Kulon Progo,0,0,0,0,0,0
Kec. Wates Kab. Kulon Progo,13,1,0,0,0,14
Kec. Galur Kab. Kulon Progo,1,1,0,0,0,2
Kec. Lendah Kab. Kulon Progo,1,0,0,0,0,1
Kec. Sentolo Kab. Kulon Progo,9,1,0,0,0,10
Kec. Pengasih Kab. Kulon Progo,0,2,0,0,0,2
Kec. Kokap Kab. Kulon Progo,1,1,0,0,0,2
Kec. Girimulyo Kab. Kulon Progo,1,1,0,0,0,2
Kec. Nanggulan Kab. Kulon Progo,0,2,0,0,0,2
Kec. Kalibawang Kab. Kulon Progo,4,0,0,0,0,4
Kec. Samigaluh Kab. Kulon Progo,1,1,0,0,0,2
Kec. Mantrijeron Kota Yogyakarta,6,0,0,0,0,6
Kec. Kraton Kota Yogyakarta,0,0,0,0,0,0
Kec. Mergangsan Kota Yogyakarta,7,1,0,0,0,8
Kec. Umbulharjo Kota Yogyakarta,12,6,0,0,0,18
Kec. Kotagede Kota Yogyakarta,4,2,0,0,0,6
Kec. Gondokusuman Kota Yogyakarta,20,4,0,0,0,24
Kec. Gondomanan Kota Yogyakarta,12,2,0,0,0,14
Kec. Ngampilan Kota Yogyakarta,1,1,0,0,0,2
Kec. Wirobrajan Kota Yogyakarta,12,0,0,0,0,12
Kec. Gedongtengen Kota Yogyakarta,0,0,0,0,0,0
Kec. Jetis Kota Yogyakarta,3,5,0,0,0,8
Kec. Tegalrejo Kota Yogyakarta,8,0,0,0,0,8
Kec. Panggul Kab. Trenggalek,2,0,0,0,0,2
Kec. Munjungan Kab. Trenggalek,2,0,0,0,0,2
Kec. Watulimo Kab. Trenggalek,0,0,0,0,0,0
Kec. Kampak Kab. Trenggalek,2,0,0,0,0,2
Kec. Dongko Kab. Trenggalek,1,1,0,0,0,2
Kec. Pule Kab. Trenggalek,0,0,0,0,0,0
Kec. Karangan Kab. Trenggalek,2,1,0,0,0,3
Kec. Durenan Kab. Trenggalek,3,1,0,0,0,4
Kec. Trenggalek Kab. Trenggalek,3,1,0,0,0,4
Kec. Tugu Kab. Trenggalek,2,0,0,0,0,2
Kec. Bendungan Kab. Trenggalek,2,0,0,0,0,2
Kec. Donomulyo Kab. Malang,1,1,0,0,0,2
Kec. Kalipare Kab. Malang,0,2,0,0,0,2
Kec. Pagak Kab. Malang,2,0,0,0,0,2
Kec. Bantur Kab. Malang,0,2,0,0,0,2
Kec. Gedangan Kab. Malang,2,0,0,0,0,2
Kec. Sumber Manjing Wetan Kab. Malang,0,2,0,0,0,2
Kec. Dampit Kab. Malang,2,2,0,0,0,4
Kec. Tirto Yudo Kab. Malang,0,0,0,0,0,0
Kec. Ampelgading Kab. Malang,2,0,0,0,0,2
Kec. Wajak Kab. Malang,4,0,0,0,0,4
Kec. Turen Kab. Malang,3,1,0,0,0,4
Kec. Pagelaran Kab. Malang,0,0,0,0,0,0
Kec. Gondanglegi Kab. Malang,4,4,0,0,0,8
Kec. Bululawang Kab. Malang,7,1,0,0,0,8
Kec. Kepanjen Kab. Malang,10,2,0,0,0,12
Kec. Sumberpucung Kab. Malang,2,0,0,0,0,2
Kec. Kromengan Kab. Malang,0,0,0,0,0,0
Kec. Ngajum Kab. Malang,0,0,0,0,0,0
Kec. Wagir Kab. Malang,0,0,0,0,0,0
Kec. Pakisaji Kab. Malang,2,0,0,0,0,2
Kec. Tajinan Kab. Malang,2,0,0,0,0,2
Kec. Tumpang Kab. Malang,7,1,0,0,0,8
Kec. Pakis Kab. Malang,0,0,0,0,0,0
Kec. Jabung Kab. Malang,1,1,0,0,0,2
Kec. Lawang Kab. Malang,6,4,0,0,0,10
Kec. Singosari Kab. Malang,7,1,0,0,0,8
Kec. Karangploso Kab. Malang,4,0,0,0,0,4
Kec. Dau Kab. Malang,7,1,0,0,0,8
Kec. Pujon Kab. Malang,2,0,0,0,0,2
Kec. Ngantang Kab. Malang,4,0,0,0,0,4
Kec. Kasembon Kab. Malang,2,0,0,0,0,2
Kec. Pragaan Kab. Sumenep,2,0,0,0,0,2
Kec. Bluto Kab. Sumenep,0,2,0,0,0,2
Kec. Giligenteng Kab. Sumenep,2,0,0,0,0,2
Kec. Talango Kab. Sumenep,0,0,0,0,0,0
Kec. Kalianget Kab. Sumenep,2,0,0,0,0,2
Kec. Kota Sumenep Kab. Sumenep,13,1,0,0,0,14
Kec. Lenteng Kab. Sumenep,4,2,0,0,0,6
Kec. Ganding Kab. Sumenep,5,1,0,0,0,6
Kec. Guluk Guluk Kab. Sumenep,6,4,0,0,0,10
Kec. Pasongsongan Kab. Sumenep,0,0,0,0,0,0
Kec. Ambunten Kab. Sumenep,2,2,0,0,0,4
Kec. Rubaru Kab. Sumenep,2,2,0,0,0,4
Kec. Dasuk Kab. Sumenep,0,0,0,0,0,0
Kec. Manding Kab. Sumenep,2,0,0,0,0,2
Kec. Batuputih Kab. Sumenep,0,0,0,0,0,0
Kec. Gapura Kab. Sumenep,2,2,0,0,0,4
Kec. Batang-Batang Kab. Sumenep,4,0,0,0,0,4
Kec. Dungkek Kab. Sumenep,2,2,0,0,0,4
Kec. Nonggunong Kab. Sumenep,0,0,0,0,0,0
Kec. Gayam Kab. Sumenep,2,0,0,0,0,2
Kec. Ra as Kab. Sumenep,0,0,0,0,0,0
Kec. Sapeken Kab. Sumenep,3,1,0,0,0,4
Kec. Arjasa Kab. Sumenep,4,0,0,0,0,4
Kec. Masalembu Kab. Sumenep,3,1,0,0,0,4
Kec. Batuan Kab. Sumenep,2,0,0,0,0,2
Kec. Kangayan Kab. Sumenep,0,0,0,0,0,0
Kec. Kamal Kab. Bangkalan,2,0,0,0,0,2
Kec. Labang Kab. Bangkalan,4,2,0,0,0,6
Kec. Kwanyar Kab. Bangkalan,2,0,0,0,0,2
Kec. Modung Kab. Bangkalan,4,6,0,0,0,10
Kec. Blega Kab. Bangkalan,11,5,0,0,0,16
Kec. Konang Kab. Bangkalan,3,1,0,0,0,4
Kec. Tanah Merah Kab. Bangkalan,1,1,0,0,0,2
Kec. Tragah Kab. Bangkalan,0,0,0,0,0,0
Kec. Socah Kab. Bangkalan,2,0,0,0,0,2
Kec. Bangkalan Kab. Bangkalan,7,3,0,0,0,10
Kec. Burneh Kab. Bangkalan,5,3,0,0,0,8
Kec. Arosbaya Kab. Bangkalan,3,1,0,0,0,4
Kec. Geger Kab. Bangkalan,0,0,0,0,0,0
Kec. Kokop Kab. Bangkalan,1,1,0,0,0,2
Kec. Tanjungbumi Kab. Bangkalan,2,2,0,0,0,4
Kec. Sepulu Kab. Bangkalan,1,1,0,0,0,2
Kec. Klampis Kab. Bangkalan,2,0,0,0,0,2
Kec. Bandar KedungMulyo Kab. Jombang,1,1,0,0,0,2
Kec. Perak Kab. Jombang,2,2,0,0,0,4
Kec. Gudo Kab. Jombang,2,0,0,0,0,2
Kec. Diwek Kab. Jombang,6,4,0,0,0,10
Kec. Ngoro Kab. Jombang,8,0,0,0,0,8
Kec. Mojowarno Kab. Jombang,0,0,0,0,0,0
Kec. Bareng Kab. Jombang,1,1,0,0,0,2
Kec. Mojoagung Kab. Jombang,4,0,0,0,0,4
Kec. Sumobito Kab. Jombang,0,1,0,0,0,1
Kec. Jogoroto Kab. Jombang,1,2,0,0,0,3
Kec. Peterongan Kab. Jombang,6,4,0,0,0,10
Kec. Jombang Kab. Jombang,12,2,0,0,0,14
Kec. Megaluh Kab. Jombang,1,1,0,0,0,2
Kec. Tembelang Kab. Jombang,0,0,0,0,0,0
Kec. Kesamben Kab. Jombang,2,0,0,0,0,2
Kec. Kudu Kab. Jombang,2,0,0,0,0,2
Kec. Ploso Kab. Jombang,6,0,0,0,0,6
Kec. Kabuh Kab. Jombang,2,2,0,0,0,4
Kec. Plandaan Kab. Jombang,1,1,0,0,0,2
Kec. Ngraho Kab. Bojonegoro,0,2,0,0,0,2
Kec. Tambakrejo Kab. Bojonegoro,0,1,0,0,0,1
Kec. Ngambon Kab. Bojonegoro,2,0,0,0,0,2
Kec. Bubulan Kab. Bojonegoro,4,0,0,0,0,4
Kec. Temayang Kab. Bojonegoro,0,0,0,0,0,0
Kec. Sugihwaras Kab. Bojonegoro,2,0,0,0,0,2
Kec. Kedungadem Kab. Bojonegoro,1,1,0,0,0,2
Kec. Kepohbaru Kab. Bojonegoro,2,6,0,0,0,8
Kec. Baureno Kab. Bojonegoro,4,0,0,0,0,4
Kec. Kanor Kab. Bojonegoro,1,1,0,0,0,2
Kec. Sumberrejo Kab. Bojonegoro,3,3,0,0,0,6
Kec. Balen Kab. Bojonegoro,0,0,0,0,0,0
Kec. Sukosewu Kab. Bojonegoro,0,2,0,0,0,2
Kec. Kapas Kab. Bojonegoro,2,0,0,0,0,2
Kec. Bojonegoro Kab. Bojonegoro,13,5,0,0,0,18
Kec. Dander Kab. Bojonegoro,1,3,0,0,0,4
Kec. Ngasem Kab. Bojonegoro,10,0,0,0,0,10
Kec. Kalitidu Kab. Bojonegoro,2,2,0,0,0,4
Kec. Malo Kab. Bojonegoro,2,0,0,0,0,2
Kec. Purwosari Kab. Bojonegoro,0,0,0,0,0,0
Kec. Padangan Kab. Bojonegoro,2,0,0,0,0,2
Kec. Kasiman Kab. Bojonegoro,2,0,0,0,0,2
Kec. Gondang Kab. Bojonegoro,0,2,0,0,0,2
Kec. Gayam Kab. Bojonegoro,0,0,0,0,0,0
Kec. Ngrayun Kab. Ponorogo,4,0,0,0,0,4
Kec. Slahung Kab. Ponorogo,4,0,0,0,0,4
Kec. Bungkal Kab. Ponorogo,2,0,0,0,0,2
Kec. Sambit Kab. Ponorogo,2,0,0,0,0,2
Kec. Sooko Kab. Ponorogo,1,1,0,0,0,2
Kec. Pulung Kab. Ponorogo,2,0,0,0,0,2
Kec. Mlarak Kab. Ponorogo,0,0,0,0,0,0
Kec. Siman Kab. Ponorogo,4,0,0,0,0,4
Kec. Jetis Kab. Ponorogo,3,0,0,0,0,3
Kec. Balong Kab. Ponorogo,4,0,0,0,0,4
Kec. Kauman Kab. Ponorogo,0,2,0,0,0,2
Kec. Jambon Kab. Ponorogo,2,0,0,0,0,2
Kec. Sampung Kab. Ponorogo,2,0,0,0,0,2
Kec. Ponorogo Kab. Ponorogo,9,5,0,0,0,14
Kec. Babadan Kab. Ponorogo,2,0,0,0,0,2
Kec. Jenangan Kab. Ponorogo,4,0,0,0,0,4
Kec. Sukapura Kab. Probolinggo,1,1,0,0,0,2
Kec. Sumber Kab. Probolinggo,0,0,0,0,0,0
Kec. Kuripan Kab. Probolinggo,0,0,0,0,0,0
Kec. Bantaran Kab. Probolinggo,4,0,0,0,0,4
Kec. Leces Kab. Probolinggo,5,3,0,0,0,8
Kec. Tegalsiwalan Kab. Probolinggo,0,0,0,0,0,0
Kec. Banyuanyar Kab. Probolinggo,0,2,0,0,0,2
Kec. Tiris Kab. Probolinggo,2,2,0,0,0,4
Kec. Krucil Kab. Probolinggo,0,0,0,0,0,0
Kec. Gading Kab. Probolinggo,5,1,0,0,0,6
Kec. Pakuniran Kab. Probolinggo,0,0,0,0,0,0
Kec. Kotaanyar Kab. Probolinggo,0,0,0,0,0,0
Kec. Paiton Kab. Probolinggo,9,1,0,0,0,10
Kec. Besuk Kab. Probolinggo,0,0,0,0,0,0
Kec. Kraksaan Kab. Probolinggo,11,1,0,0,0,12
Kec. Krejengan Kab. Probolinggo,3,1,0,0,0,4
Kec. Pajarakan Kab. Probolinggo,2,2,0,0,0,4
Kec. Maron Kab. Probolinggo,1,1,0,0,0,2
Kec. Gending Kab. Probolinggo,3,1,0,0,0,4
Kec. Dringu Kab. Probolinggo,1,1,0,0,0,2
Kec. Tongas Kab. Probolinggo,2,2,0,0,0,4
Kec. Sumberasih Kab. Probolinggo,4,2,0,0,0,6
Kec. Kedungkandang Kota Malang,12,4,0,0,0,16
Kec. Sukun Kota Malang,12,0,0,0,0,12
Kec. Klojen Kota Malang,37,3,0,0,0,40
Kec. Blimbing Kota Malang,4,0,0,0,0,4
Kec. Lowokwaru Kota Malang,25,7,0,0,0,32
Kec. Manguharjo Kota Madiun,7,1,0,0,0,8
Kec. Taman Kota Madiun,6,4,0,0,0,10
Kec. Kartoharjo Kota Madiun,8,2,0,0,0,10
Kec. Mojoroto Kota Kediri,18,12,0,0,0,30
Kec. Kota Kediri Kota Kediri,10,2,0,0,0,12
Kec. Pesantren Kota Kediri,2,0,0,0,0,2
Kec. Prajurit Kulon Kota Mojokerto,9,3,0,0,0,12
Kec. Magersari Kota Mojokerto,13,1,0,0,0,14
Kec. Sukorejo Kota Blitar,3,1,0,0,0,4
Kec. Kepanjenkidul Kota Blitar,12,2,0,0,0,14
Kec. Sananwetan Kota Blitar,10,2,0,0,0,12
Kec. Gadingrejo Kota Pasuruan,2,0,0,0,0,2
Kec. Purworejo Kota Pasuruan,3,1,0,0,0,4
Kec. Bugul Kidul Kota Pasuruan,6,0,0,0,0,6
Kec. Panggungrejo Kota Pasuruan,6,2,0,0,0,8
Kec. Kademangan Kota Probolinggo,4,0,0,0,0,4
Kec. Wonoasih Kota Probolinggo,2,0,0,0,0,2
Kec. Mayangan Kota Probolinggo,4,0,0,0,0,4
Kec. Kanigaran Kota Probolinggo,8,2,0,0,0,10
Kec. Batu Kota Batu,11,3,0,0,0,14
Kec. Junrejo Kota Batu,2,0,0,0,0,2
Kec. Bumiaji Kota Batu,4,0,0,0,0,4
Kec. Kenduruan Kab. Tuban,0,0,0,0,0,0
Kec. Bangilan Kab. Tuban,2,0,0,0,0,2
Kec. Senori Kab. Tuban,2,0,0,0,0,2
Kec. Singgahan Kab. Tuban,1,1,0,0,0,2
Kec. Montong Kab. Tuban,2,0,0,0,0,2
Kec. Parengan Kab. Tuban,0,2,0,0,0,2
Kec. Soko Kab. Tuban,2,2,0,0,0,4
Kec. Rengel Kab. Tuban,2,0,0,0,0,2
Kec. Plumpang Kab. Tuban,3,1,0,0,0,4
Kec. Widang Kab. Tuban,0,0,0,0,0,0
Kec. Palang Kab. Tuban,1,1,0,0,0,2
Kec. Semanding Kab. Tuban,7,0,0,0,0,7
Kec. Tuban Kab. Tuban,13,1,0,0,0,14
Kec. Jenu Kab. Tuban,0,0,0,0,0,0
Kec. Kerek Kab. Tuban,0,0,0,0,0,0
Kec. Tambakboyo Kab. Tuban,0,2,0,0,0,2
Kec. Jatirogo Kab. Tuban,2,0,0,0,0,2
Kec. Bancar Kab. Tuban,1,3,0,0,0,4
Kec. Grabagan Kab. Tuban,0,0,0,0,0,0
Kec. Berbek Kab. Nganjuk,1,1,0,0,0,2
Kec. Loceret Kab. Nganjuk,3,1,0,0,0,4
Kec. Pace Kab. Nganjuk,0,0,0,0,0,0
Kec. Tanjunganom Kab. Nganjuk,7,3,0,0,0,10
Kec. Prambon Kab. Nganjuk,2,0,0,0,0,2
Kec. Ngronggot Kab. Nganjuk,0,0,0,0,0,0
Kec. Kertosono Kab. Nganjuk,4,2,0,0,0,6
Kec. Patianrowo Kab. Nganjuk,6,0,0,0,0,6
Kec. Baron Kab. Nganjuk,1,1,0,0,0,2
Kec. Gondang Kab. Nganjuk,4,0,0,0,0,4
Kec. Sukomoro Kab. Nganjuk,1,1,0,0,0,2
Kec. Nganjuk Kab. Nganjuk,7,3,0,0,0,10
Kec. Rejoso Kab. Nganjuk,2,0,0,0,0,2
Kec. Lengkong Kab. Nganjuk,0,0,0,0,0,0
Kec. Kencong Kab. Jember,1,3,0,0,0,4
Kec. Gumuk Mas Kab. Jember,1,1,0,0,0,2
Kec. Puger Kab. Jember,0,0,0,0,0,0
Kec. Wuluhan Kab. Jember,2,0,0,0,0,2
Kec. Ambulu Kab. Jember,7,1,0,0,0,8
Kec. Tempurejo Kab. Jember,2,0,0,0,0,2
Kec. Silo Kab. Jember,0,0,0,0,0,0
Kec. Mayang Kab. Jember,1,1,0,0,0,2
Kec. Mumbulsari Kab. Jember,4,0,0,0,0,4
Kec. Jenggawah Kab. Jember,2,0,0,0,0,2
Kec. Rambipuji Kab. Jember,6,2,0,0,0,8
Kec. Balung Kab. Jember,3,1,0,0,0,4
Kec. Umbulsari Kab. Jember,2,0,0,0,0,2
Kec. Semboro Kab. Jember,2,0,0,0,0,2
Kec. Jombang Kab. Jember,1,1,0,0,0,2
Kec. Sumberbaru Kab. Jember,0,0,0,0,0,0
Kec. Tanggul Kab. Jember,2,2,0,0,0,4
Kec. Bangsalsari Kab. Jember,0,0,0,0,0,0
Kec. Panti Kab. Jember,1,1,0,0,0,2
Kec. Arjasa Kab. Jember,1,1,0,0,0,2
Kec. Pakusari Kab. Jember,2,0,0,0,0,2
Kec. Kalisat Kab. Jember,3,1,0,0,0,4
Kec. Sumberjambe Kab. Jember,1,1,0,0,0,2
Kec. Sukowono Kab. Jember,3,1,0,0,0,4
Kec. Jelbuk Kab. Jember,0,0,0,0,0,0
Kec. Kaliwates Kab. Jember,6,9,0,0,0,15
Kec. Sumbersari Kab. Jember,12,6,0,0,0,18
Kec. Patrang Kab. Jember,4,2,0,0,0,6
Kec. Pesanggaran Kab. Banyuwangi,2,0,0,0,0,2
Kec. Bangorejo Kab. Banyuwangi,1,1,0,0,0,2
Kec. Purwoharjo Kab. Banyuwangi,4,2,0,0,0,6
Kec. Tegaldlimo Kab. Banyuwangi,2,0,0,0,0,2
Kec. Muncar Kab. Banyuwangi,3,1,0,0,0,4
Kec. Cluring Kab. Banyuwangi,1,1,0,0,0,2
Kec. Gambiran Kab. Banyuwangi,3,1,0,0,0,4
Kec. Glenmore Kab. Banyuwangi,4,4,0,0,0,8
Kec. Kalibaru Kab. Banyuwangi,0,0,0,0,0,0
Kec. Genteng Kab. Banyuwangi,11,3,0,0,0,14
Kec. Srono Kab. Banyuwangi,5,3,0,0,0,8
Kec. Rogojampi Kab. Banyuwangi,0,4,0,0,0,4
Kec. Kabat Kab. Banyuwangi,1,1,0,0,0,2
Kec. Singojuruh Kab. Banyuwangi,4,0,0,0,0,4
Kec. Sempu Kab. Banyuwangi,0,0,0,0,0,0
Kec. Songgon Kab. Banyuwangi,2,2,0,0,0,4
Kec. Glagah Kab. Banyuwangi,1,1,0,0,0,2
Kec. Banyuwangi Kab. Banyuwangi,7,3,0,0,0,10
Kec. Giri Kab. Banyuwangi,4,0,0,0,0,4
Kec. Kalipuro Kab. Banyuwangi,2,0,0,0,0,2
Kec. Wongsorejo Kab. Banyuwangi,3,1,0,0,0,4
Kec. Tegalsari Kab. Banyuwangi,0,0,0,0,0,0
Kec. Siliragung Kab. Banyuwangi,1,1,0,0,0,2
Kec. Punung Kab. Pacitan,2,0,0,0,0,2
Kec. Pacitan Kab. Pacitan,4,0,0,0,0,4
Kec. Nawangan Kab. Pacitan,4,0,0,0,0,4
Kec. Bandar Kab. Pacitan,0,0,0,0,0,0
Kec. Tegalombo Kab. Pacitan,1,1,0,0,0,2
Kec. Tulakan Kab. Pacitan,2,0,0,0,0,2
Kec. Ngadirojo Kab. Pacitan,0,2,0,0,0,2
Kec. Sudimoro Kab. Pacitan,0,0,0,0,0,0
Kec. Kras Kab. Kediri,2,0,0,0,0,2
Kec. Kepung Kab. Kediri,4,0,0,0,0,4
Kec. Puncu Kab. Kediri,0,0,0,0,0,0
Kec. Plosoklaten Kab. Kediri,0,0,0,0,0,0
Kec. Wates Kab. Kediri,3,1,0,0,0,4
Kec. Kandat Kab. Kediri,0,4,0,0,0,4
Kec. Ngadiluwih Kab. Kediri,1,1,0,0,0,2
Kec. Mojo Kab. Kediri,2,2,0,0,0,4
Kec. Semen Kab. Kediri,0,0,0,0,0,0
Kec. Tarokan Kab. Kediri,2,0,0,0,0,2
Kec. Grogol Kab. Kediri,4,0,0,0,0,4
Kec. Gurah Kab. Kediri,2,0,0,0,0,2
Kec. Papar Kab. Kediri,2,0,0,0,0,2
Kec. Plemahan Kab. Kediri,3,1,0,0,0,4
Kec. Purwoasri Kab. Kediri,2,0,0,0,0,2
Kec. Pare Kab. Kediri,8,2,0,0,0,10
Kec. Kandangan Kab. Kediri,0,2,0,0,0,2
Kec. Badas Kab. Kediri,0,0,0,0,0,0
Kec. Tempursari Kab. Lumajang,4,0,0,0,0,4
Kec. Pronojiwo Kab. Lumajang,2,0,0,0,0,2
Kec. Candipuro Kab. Lumajang,4,0,0,0,0,4
Kec. Pasirian Kab. Lumajang,2,0,0,0,0,2
Kec. Tempeh Kab. Lumajang,6,0,0,0,0,6
Kec. Kunir Kab. Lumajang,3,1,0,0,0,4
Kec. Yosowilangun Kab. Lumajang,3,1,0,0,0,4
Kec. Tekung Kab. Lumajang,2,0,0,0,0,2
Kec. Lumajang Kab. Lumajang,19,1,0,0,0,20
Kec. Senduro Kab. Lumajang,0,0,0,0,0,0
Kec. Jatiroto Kab. Lumajang,2,0,0,0,0,2
Kec. Randuagung Kab. Lumajang,0,0,0,0,0,0
Kec. Klakah Kab. Lumajang,1,1,0,0,0,2
Kec. Ranuyoso Kab. Lumajang,0,0,0,0,0,0
Kec. Grujugan Kab. Bondowoso,2,0,0,0,0,2
Kec. Tamanan Kab. Bondowoso,1,1,0,0,0,2
Kec. Pujer Kab. Bondowoso,2,0,0,0,0,2
Kec. Tlogosari Kab. Bondowoso,0,0,0,0,0,0
Kec. Sukosari Kab. Bondowoso,1,1,0,0,0,2
Kec. Tapen Kab. Bondowoso,2,0,0,0,0,2
Kec. Tenggarang Kab. Bondowoso,1,1,0,0,0,2
Kec. Bondowoso Kab. Bondowoso,7,3,0,0,0,10
Kec. Curahdami Kab. Bondowoso,0,2,0,0,0,2
Kec. Wringin Kab. Bondowoso,3,1,0,0,0,4
Kec. Prajekan Kab. Bondowoso,0,2,0,0,0,2
Kec. Cermee Kab. Bondowoso,0,0,0,0,0,0
Kec. Sumber Wringin Kab. Bondowoso,1,1,0,0,0,2
Kec. Jambesari Darus Sholah Kab. Bondowoso,0,0,0,0,0,0
Kec. Botolinggo Kab. Bondowoso,0,2,0,0,0,2
Kec. Banyuglugur Kab. Situbondo,1,1,0,0,0,2
Kec. Besuki Kab. Situbondo,2,0,0,0,0,2
Kec. Suboh Kab. Situbondo,1,1,0,0,0,2
Kec. Panarukan Kab. Situbondo,0,0,0,0,0,0
Kec. Situbondo Kab. Situbondo,1,3,0,0,0,4
Kec. Panji Kab. Situbondo,6,2,0,0,0,8
Kec. Kapongan Kab. Situbondo,2,0,0,0,0,2
Kec. Arjasa Kab. Situbondo,2,0,0,0,0,2
Kec. Asembagus Kab. Situbondo,1,1,0,0,0,2
Kec. Banyuputih Kab. Situbondo,9,1,0,0,0,10
Kec. Jatirejo Kab. Mojokerto,3,1,0,0,0,4
Kec. Gondang Kab. Mojokerto,6,0,0,0,0,6
Kec. Pacet Kab. Mojokerto,5,3,0,0,0,8
Kec. Trawas Kab. Mojokerto,2,0,0,0,0,2
Kec. Ngoro Kab. Mojokerto,6,0,0,0,0,6
Kec. Pungging Kab. Mojokerto,1,1,0,0,0,2
Kec. Kutorejo Kab. Mojokerto,4,0,0,0,0,4
Kec. Mojosari Kab. Mojokerto,7,1,0,0,0,8
Kec. Bangsal Kab. Mojokerto,2,0,0,0,0,2
Kec. Dlanggu Kab. Mojokerto,2,0,0,0,0,2
Kec. Puri Kab. Mojokerto,3,7,0,0,0,10
Kec. Trowulan Kab. Mojokerto,0,0,0,0,0,0
Kec. Sooko Kab. Mojokerto,3,1,0,0,0,4
Kec. Gedeg Kab. Mojokerto,4,2,0,0,0,6
Kec. Kemlagi Kab. Mojokerto,2,0,0,0,0,2
Kec. Jetis Kab. Mojokerto,1,1,0,0,0,2
Kec. Dawar Blandong Kab. Mojokerto,3,1,0,0,0,4
Kec. Mojoanyar Kab. Mojokerto,0,0,0,0,0,0
Kec. Sine Kab. Ngawi,2,0,0,0,0,2
Kec. Ngrambe Kab. Ngawi,1,1,0,0,0,2
Kec. Jogorogo Kab. Ngawi,3,1,0,0,0,4
Kec. Kendal Kab. Ngawi,0,0,0,0,0,0
Kec. Geneng Kab. Ngawi,12,0,0,0,0,12
Kec. Kwadungan Kab. Ngawi,2,0,0,0,0,2
Kec. Karangjati Kab. Ngawi,1,1,0,0,0,2
Kec. Ngawi Kab. Ngawi,5,1,0,0,0,6
Kec. Paron Kab. Ngawi,3,1,0,0,0,4
Kec. Kedunggalar Kab. Ngawi,5,1,0,0,0,6
Kec. Widodaren Kab. Ngawi,2,0,0,0,0,2
Kec. Poncol Kab. Magetan,1,1,0,0,0,2
Kec. Parang Kab. Magetan,2,0,0,0,0,2
Kec. Kawedanan Kab. Magetan,2,0,0,0,0,2
Kec. Magetan Kab. Magetan,9,1,0,0,0,10
Kec. Plaosan Kab. Magetan,2,0,0,0,0,2
Kec. Sukomoro Kab. Magetan,2,0,0,0,0,2
Kec. Maospati Kab. Magetan,2,2,0,0,0,4
Kec. Barat Kab. Magetan,4,0,0,0,0,4
Kec. Karas Kab. Magetan,1,0,0,0,0,1
Kec. Sidorejo Kab. Magetan,1,1,0,0,0,2
Kec. Purwodadi Kab. Pasuruan,6,0,0,0,0,6
Kec. Tutur Kab. Pasuruan,1,1,0,0,0,2
Kec. Tosari Kab. Pasuruan,3,1,0,0,0,4
Kec. Lumbang Kab. Pasuruan,1,1,0,0,0,2
Kec. Kejayan Kab. Pasuruan,2,0,0,0,0,2
Kec. Wonorejo Kab. Pasuruan,2,0,0,0,0,2
Kec. Purwosari Kab. Pasuruan,0,6,0,0,0,6
Kec. Prigen Kab. Pasuruan,4,2,0,0,0,6
Kec. Sukorejo Kab. Pasuruan,1,1,0,0,0,2
Kec. Pandaan Kab. Pasuruan,6,4,0,0,0,10
Kec. Gempol Kab. Pasuruan,1,1,0,0,0,2
Kec. Beji Kab. Pasuruan,0,2,0,0,0,2
Kec. Bangil Kab. Pasuruan,5,1,0,0,0,6
Kec. Kraton Kab. Pasuruan,4,0,0,0,0,4
Kec. Pohjentrek Kab. Pasuruan,3,1,0,0,0,4
Kec. Gondang Wetan Kab. Pasuruan,1,1,0,0,0,2
Kec. Grati Kab. Pasuruan,0,0,0,0,0,0
Kec. Lekok Kab. Pasuruan,2,0,0,0,0,2
Kec. Nguling Kab. Pasuruan,2,0,0,0,0,2
Kec. Karang Pilang Kota Surabaya,5,1,0,0,0,6
Kec. Jambangan Kota Surabaya,4,2,0,0,0,6
Kec. Gayungan Kota Surabaya,11,1,0,0,0,12
Kec. Wonocolo Kota Surabaya,33,1,0,0,0,34
Kec. Tenggilis Mejoyo Kota Surabaya,2,2,0,0,0,4
Kec. Rungkut Kota Surabaya,8,4,0,0,0,12
Kec. Sukolilo Kota Surabaya,25,5,0,0,0,30
Kec. Mulyorejo Kota Surabaya,22,0,0,0,0,22
Kec. Gubeng Kota Surabaya,18,0,0,0,0,18
Kec. Wonokromo Kota Surabaya,12,2,0,0,0,14
Kec. Dukuh Pakis Kota Surabaya,14,0,0,0,0,14
Kec. Wiyung Kota Surabaya,7,3,0,0,0,10
Kec. Lakarsantri Kota Surabaya,11,1,0,0,0,12
Kec. Tandes Kota Surabaya,7,1,0,0,0,8
Kec. Sukomanunggal Kota Surabaya,13,1,0,0,0,14
Kec. Sawahan Kota Surabaya,12,4,0,0,0,16
Kec. Tegal Sari Kota Surabaya,10,0,0,0,0,10
Kec. Genteng Kota Surabaya,17,5,0,0,0,22
Kec. Tambaksari Kota Surabaya,15,1,0,0,0,16
Kec. Kenjeran Kota Surabaya,5,1,0,0,0,6
Kec. Simokerto Kota Surabaya,7,1,0,0,0,8
Kec. Semampir Kota Surabaya,15,0,0,0,0,15
Kec. Pabean Cantian Kota Surabaya,5,1,0,0,0,6
Kec. Bubutan Kota Surabaya,2,0,0,0,0,2
Kec. Krembangan Kota Surabaya,13,3,0,0,0,16
Kec. Asemrowo Kota Surabaya,2,0,0,0,0,2
Kec. Benowo Kota Surabaya,6,0,0,0,0,6
Kec. Bulak Kota Surabaya,2,2,0,0,0,4
Kec. Pakal Kota Surabaya,3,3,0,0,0,6
Kec. Sambi Kerep Kota Surabaya,16,0,0,0,0,16
Kec. Wringin Anom Kab. Gresik,2,0,0,0,0,2
Kec. Driyorejo Kab. Gresik,6,2,0,0,0,8
Kec. Kedamean Kab. Gresik,2,2,0,0,0,4
Kec. Menganti Kab. Gresik,4,2,0,0,0,6
Kec. Cerme Kab. Gresik,5,1,0,0,0,6
Kec. Benjeng Kab. Gresik,3,1,0,0,0,4
Kec. Balong Panggang Kab. Gresik,1,1,0,0,0,2
Kec. Duduk Sampeyan Kab. Gresik,0,0,0,0,0,0
Kec. Kebomas Kab. Gresik,2,2,0,0,0,4
Kec. Gresik Kab. Gresik,9,3,0,0,0,12
Kec. Manyar Kab. Gresik,2,2,0,0,0,4
Kec. Bungah Kab. Gresik,1,3,0,0,0,4
Kec. Sidayu Kab. Gresik,4,2,0,0,0,6
Kec. Dukun Kab. Gresik,1,1,0,0,0,2
Kec. Panceng Kab. Gresik,2,0,0,0,0,2
Kec. Ujung Pangkah Kab. Gresik,4,4,0,0,0,8
Kec. Sangkapura Kab. Gresik,1,3,0,0,0,4
Kec. Tambak Kab. Gresik,2,0,0,0,0,2
Kec. Sukorame Kab. Lamongan,0,0,0,0,0,0
Kec. Bluluk Kab. Lamongan,2,0,0,0,0,2
Kec. Ngimbang Kab. Lamongan,4,2,0,0,0,6
Kec. Sambeng Kab. Lamongan,0,0,0,0,0,0
Kec. Mantup Kab. Lamongan,2,0,0,0,0,2
Kec. Kembang Bahu Kab. Lamongan,1,1,0,0,0,2
Kec. Sugio Kab. Lamongan,0,2,0,0,0,2
Kec. Kedungpring Kab. Lamongan,6,0,0,0,0,6
Kec. Modo Kab. Lamongan,1,1,0,0,0,2
Kec. Babat Kab. Lamongan,7,3,0,0,0,10
Kec. Pucuk Kab. Lamongan,0,2,0,0,0,2
Kec. Sukodadi Kab. Lamongan,1,3,0,0,0,4
Kec. Lamongan Kab. Lamongan,10,2,0,0,0,12
Kec. Deket Kab. Lamongan,0,0,0,0,0,0
Kec. Glagah Kab. Lamongan,1,1,0,0,0,2
Kec. Karangbinangun Kab. Lamongan,0,2,0,0,0,2
Kec. Kalitengah Kab. Lamongan,0,0,0,0,0,0
Kec. Karang Geneng Kab. Lamongan,2,0,0,0,0,2
Kec. Sekaran Kab. Lamongan,4,2,0,0,0,6
Kec. Maduran Kab. Lamongan,2,2,0,0,0,4
Kec. Laren Kab. Lamongan,1,1,0,0,0,2
Kec. Solokuro Kab. Lamongan,6,2,0,0,0,8
Kec. Paciran Kab. Lamongan,5,5,0,0,0,10
Kec. Brondong Kab. Lamongan,5,3,0,0,0,8
Kec. Sarirejo Kab. Lamongan,1,1,0,0,0,2
Kec. Wonotirto Kab. Blitar,1,1,0,0,0,2
Kec. Wates Kab. Blitar,2,0,0,0,0,2
Kec. Sutojayan Kab. Blitar,2,0,0,0,0,2
Kec. Kademangan Kab. Blitar,0,2,0,0,0,2
Kec. Talun Kab. Blitar,2,2,0,0,0,4
Kec. Kesamben Kab. Blitar,6,4,0,0,0,10
Kec. Wlingi Kab. Blitar,2,0,0,0,0,2
Kec. Garum Kab. Blitar,4,2,0,0,0,6
Kec. Sanankulon Kab. Blitar,3,1,0,0,0,4
Kec. Ponggok Kab. Blitar,2,2,0,0,0,4
Kec. Srengat Kab. Blitar,6,0,0,0,0,6
Kec. Wonodadi Kab. Blitar,0,0,0,0,0,0
Kec. Besuki Kab. Tulungagung,2,0,0,0,0,2
Kec. Bandung Kab. Tulungagung,1,1,0,0,0,2
Kec. Pakel Kab. Tulungagung,4,0,0,0,0,4
Kec. Campur Darat Kab. Tulungagung,1,1,0,0,0,2
Kec. Kalidawir Kab. Tulungagung,5,1,0,0,0,6
Kec. Rejotangan Kab. Tulungagung,6,2,0,0,0,8
Kec. Ngunut Kab. Tulungagung,5,1,0,0,0,6
Kec. Boyolangu Kab. Tulungagung,2,0,0,0,0,2
Kec. Tulungagung Kab. Tulungagung,5,1,0,0,0,6
Kec. Kedungwaru Kab. Tulungagung,3,1,0,0,0,4
Kec. Karangrejo Kab. Tulungagung,3,1,0,0,0,4
Kec. Kauman Kab. Tulungagung,2,0,0,0,0,2
Kec. Gondang Kab. Tulungagung,2,0,0,0,0,2
Kec. Sendang Kab. Tulungagung,0,0,0,0,0,0
Kec. Tlanakan Kab. Pamekasan,2,4,0,0,0,6
Kec. Pademawu Kab. Pamekasan,5,3,0,0,0,8
Kec. Galis Kab. Pamekasan,1,1,0,0,0,2
Kec. Larangan Kab. Pamekasan,1,3,0,0,0,4
Kec. Pamekasan Kab. Pamekasan,18,2,0,0,0,20
Kec. Proppo Kab. Pamekasan,1,1,0,0,0,2
Kec. Palengaan Kab. Pamekasan,4,8,0,0,0,12
Kec. Pegantenan Kab. Pamekasan,1,1,0,0,0,2
Kec. Kadur Kab. Pamekasan,3,9,0,0,0,12
Kec. Pakong Kab. Pamekasan,7,1,0,0,0,8
Kec. Waru Kab. Pamekasan,1,1,0,0,0,2
Kec. Batu Marmar Kab. Pamekasan,0,0,0,0,0,0
Kec. Pasean Kab. Pamekasan,2,0,0,0,0,2
Kec. Sreseh Kab. Sampang,6,0,0,0,0,6
Kec. Torjun Kab. Sampang,2,0,0,0,0,2
Kec. Sampang Kab. Sampang,7,3,0,0,0,10
Kec. Camplong Kab. Sampang,4,0,0,0,0,4
Kec. Omben Kab. Sampang,2,0,0,0,0,2
Kec. Kedungdung Kab. Sampang,4,2,0,0,0,6
Kec. Tambelangan Kab. Sampang,1,1,0,0,0,2
Kec. Banyuates Kab. Sampang,3,1,0,0,0,4
Kec. Robatal Kab. Sampang,5,1,0,0,0,6
Kec. Ketapang Kab. Sampang,4,2,0,0,0,6
Kec. Sokobanah Kab. Sampang,4,2,0,0,0,6
Kec. Karangpenang Kab. Sampang,2,2,0,0,0,4
Kec. Pangarengan Kab. Sampang,4,0,0,0,0,4
Kec. Tarik Kab. Sidoarjo,2,0,0,0,0,2
Kec. Prambon Kab. Sidoarjo,2,0,0,0,0,2
Kec. Krembung Kab. Sidoarjo,0,2,0,0,0,2
Kec. Porong Kab. Sidoarjo,9,1,0,0,0,10
Kec. Jabon Kab. Sidoarjo,1,1,0,0,0,2
Kec. Tanggulangin Kab. Sidoarjo,3,1,0,0,0,4
Kec. Candi Kab. Sidoarjo,2,0,0,0,0,2
Kec. Tulangan Kab. Sidoarjo,2,2,0,0,0,4
Kec. Wonoayu Kab. Sidoarjo,10,0,0,0,0,10
Kec. Sukodono Kab. Sidoarjo,1,1,0,0,0,2
Kec. Sidoarjo Kab. Sidoarjo,27,5,0,0,0,32
Kec. Buduran Kab. Sidoarjo,4,0,0,0,0,4
Kec. Sedati Kab. Sidoarjo,5,1,0,0,0,6
Kec. Waru Kab. Sidoarjo,7,1,0,0,0,8
Kec. Gedangan Kab. Sidoarjo,6,2,0,0,0,8
Kec. Taman Kab. Sidoarjo,9,3,0,0,0,12
Kec. Krian Kab. Sidoarjo,15,1,0,0,0,16
Kec. Balong Bendo Kab. Sidoarjo,3,1,0,0,0,4
Kec. Geger Kab. Madiun,1,1,0,0,0,2
Kec. Dolopo Kab. Madiun,1,1,0,0,0,2
Kec. Dagangan Kab. Madiun,4,2,0,0,0,6
Kec. Wungu Kab. Madiun,1,1,0,0,0,2
Kec. Saradan Kab. Madiun,1,1,0,0,0,2
Kec. Pilangkenceng Kab. Madiun,2,0,0,0,0,2
Kec. Mejayan Kab. Madiun,5,1,0,0,0,6
Kec. Madiun Kab. Madiun,3,1,0,0,0,4
Kec. Jiwan Kab. Madiun,4,2,0,0,0,6
Kec. Sawang Kab. Aceh Utara,0,0,0,0,0,0
Kec. Nisam Kab. Aceh Utara,2,0,0,0,0,2
Kec. Kuta Makmur Kab. Aceh Utara,2,0,0,0,0,2
Kec. Syamtalira Bayu Kab. Aceh Utara,0,1,0,0,0,1
Kec. Meurah Mulia Kab. Aceh Utara,1,1,0,0,0,2
Kec. Matangkuli Kab. Aceh Utara,4,2,0,0,0,6
Kec. Cot Girek Kab. Aceh Utara,0,0,0,0,0,0
Kec. Tanah Jambo Aye Kab. Aceh Utara,5,3,0,0,0,8
Kec. Seunuddon Kab. Aceh Utara,6,2,0,0,0,8
Kec. Baktiya Kab. Aceh Utara,4,0,0,0,0,4
Kec. Tanah Luas Kab. Aceh Utara,4,0,0,0,0,4
Kec. Samudera Kab. Aceh Utara,0,0,0,0,0,0
Kec. Syamtalira Aron Kab. Aceh Utara,1,1,0,0,0,2
Kec. Tanah Pasir Kab. Aceh Utara,2,2,0,0,0,4
Kec. Langkahan Kab. Aceh Utara,0,0,0,0,0,0
Kec. Baktiya Barat Kab. Aceh Utara,0,0,0,0,0,0
Kec. Simpang Keramat Kab. Aceh Utara,0,0,0,0,0,0
Kec. Nibong Kab. Aceh Utara,2,0,0,0,0,2
Kec. Paya Bakong Kab. Aceh Utara,1,1,0,0,0,2
Kec. Muara Batu Kab. Aceh Utara,0,2,0,0,0,2
Kec. Dewantara Kab. Aceh Utara,10,0,0,0,0,10
Kec. Lhoksukon Kab. Aceh Utara,8,4,0,0,0,12
Kec. Pirak Timu Kab. Aceh Utara,0,2,0,0,0,2
Kec. Geureudong Pase Kab. Aceh Utara,2,0,0,0,0,2
Kec. Banda Baro Kab. Aceh Utara,0,0,0,0,0,0
Kec. Nisam Antara Kab. Aceh Utara,1,1,0,0,0,2
Kec. Trumon Kab. Aceh Selatan,0,0,0,0,0,0
Kec. Bakongan Kab. Aceh Selatan,20,2,0,0,0,22
Kec. Kluet Selatan Kab. Aceh Selatan,1,1,0,0,0,2
Kec. Kluet Utara Kab. Aceh Selatan,2,0,0,0,0,2
Kec. Tapak Tuan Kab. Aceh Selatan,1,3,0,0,0,4
Kec. Samadua Kab. Aceh Selatan,2,0,0,0,0,2
Kec. Sawang Kab. Aceh Selatan,0,0,0,0,0,0
Kec. Meukek Kab. Aceh Selatan,0,2,0,0,0,2
Kec. Labuhan Haji Kab. Aceh Selatan,3,1,0,0,0,4
Kec. Pasie Raja Kab. Aceh Selatan,0,0,0,0,0,0
Kec. Trumon Timur Kab. Aceh Selatan,1,1,0,0,0,2
Kec. Kluet Timur Kab. Aceh Selatan,0,0,0,0,0,0
Kec. Bakongan Timur Kab. Aceh Selatan,0,0,0,0,0,0
Kec. Kluet Tengah Kab. Aceh Selatan,0,0,0,0,0,0
Kec. Labuhan Haji Barat Kab. Aceh Selatan,2,0,0,0,0,2
Kec. Labuhan Haji Timur Kab. Aceh Selatan,0,0,0,0,0,0
Kec. Kota Bahagia Kab. Aceh Selatan,1,1,0,0,0,2
Kec. Trumon Tengah Kab. Aceh Selatan,0,0,0,0,0,0
Kec. Lawe Alas Kab. Aceh Tenggara,0,0,0,0,0,0
Kec. Lawe Sigala-Gala Kab. Aceh Tenggara,0,2,0,0,0,2
Kec. Babussalam Kab. Aceh Tenggara,3,3,0,0,0,6
Kec. Badar Kab. Aceh Tenggara,0,0,0,0,0,0
Kec. Darul Hasanah Kab. Aceh Tenggara,0,0,0,0,0,0
Kec. Babul Makmur Kab. Aceh Tenggara,1,3,0,0,0,4
Kec. Lawe Bulan Kab. Aceh Tenggara,0,0,0,0,0,0
Kec. Bukit Tusam Kab. Aceh Tenggara,0,0,0,0,0,0
Kec. Semadam Kab. Aceh Tenggara,0,0,0,0,0,0
Kec. Babul Rahmat Kab. Aceh Tenggara,0,0,0,0,0,0
Kec. Ketambe Kab. Aceh Tenggara,0,0,0,0,0,0
Kec. Lawe Sumur Kab. Aceh Tenggara,0,0,0,0,0,0
Kec. Tanoh Alas Kab. Aceh Tenggara,0,0,0,0,0,0
Kec. Lueser Kab. Aceh Tenggara,0,0,0,0,0,0
Kec. Simpang Kiri Kota Subulussalam,5,5,0,0,0,10
Kec. Penanggalan Kota Subulussalam,0,0,0,0,0,0
Kec. Rundeng Kota Subulussalam,0,0,0,0,0,0
Kec. Sultan Daulat Kota Subulussalam,2,0,0,0,0,2
Kec. Longkib Kota Subulussalam,0,0,0,0,0,0
Kec. Lhoong Kab. Aceh Besar,0,0,0,0,0,0
Kec. Lhoknga Kab. Aceh Besar,1,1,0,0,0,2
Kec. Indrapuri Kab. Aceh Besar,4,2,0,0,0,6
Kec. Seulimeum Kab. Aceh Besar,3,1,0,0,0,4
Kec. Mesjid Raya Kab. Aceh Besar,0,0,0,0,0,0
Kec. Darussalam Kab. Aceh Besar,1,1,0,0,0,2
Kec. Kuta Baro Kab. Aceh Besar,5,0,0,0,0,5
Kec. Montasik Kab. Aceh Besar,2,2,0,0,0,4
Kec. Ingin Jaya Kab. Aceh Besar,11,1,0,0,0,12
Kec. Suka Makmur Kab. Aceh Besar,2,0,0,0,0,2
Kec. Darul Imarah Kab. Aceh Besar,9,1,0,0,0,10
Kec. Peukan Bada Kab. Aceh Besar,4,0,0,0,0,4
Kec. Pulo Aceh Kab. Aceh Besar,2,0,0,0,0,2
Kec. Leupung Kab. Aceh Besar,0,0,0,0,0,0
Kec. Kuta Malaka Kab. Aceh Besar,4,0,0,0,0,4
Kec. Lembah Seulawah Kab. Aceh Besar,2,0,0,0,0,2
Kec. Kota Jantho Kab. Aceh Besar,0,2,0,0,0,2
Kec. Baitussalam Kab. Aceh Besar,0,2,0,0,0,2
Kec. Krung Barona Jaya Kab. Aceh Besar,1,1,0,0,0,2
Kec. Simpang Tiga Kab. Aceh Besar,4,0,0,0,0,4
Kec. Kuta Cot Glie Kab. Aceh Besar,0,2,0,0,0,2
Kec. Blang Bintang Kab. Aceh Besar,6,0,0,0,0,6
Kec. Birem Bayeun Kab. Aceh Timur,2,0,0,0,0,2
Kec. Rantau Selamat Kab. Aceh Timur,1,1,0,0,0,2
Kec. Peureulak Kab. Aceh Timur,4,0,0,0,0,4
Kec. Ranto Peureulak Kab. Aceh Timur,0,2,0,0,0,2
Kec. Idi Rayeuk Kab. Aceh Timur,1,1,0,0,0,2
Kec. Darul Aman Kab. Aceh Timur,2,0,0,0,0,2
Kec. Nurussalam Kab. Aceh Timur,0,0,0,0,0,0
Kec. Julok Kab. Aceh Timur,0,0,0,0,0,0
Kec. Pante Beudari Kab. Aceh Timur,0,2,0,0,0,2
Kec. Simpang Ulim Kab. Aceh Timur,1,1,0,0,0,2
Kec. Sungai Raya Kab. Aceh Timur,2,0,0,0,0,2
Kec. Peureulak Barat Kab. Aceh Timur,0,0,0,0,0,0
Kec. Banda Alam Kab. Aceh Timur,2,0,0,0,0,2
Kec. Idi Tunong Kab. Aceh Timur,2,0,0,0,0,2
Kec. Peudawa Kab. Aceh Timur,0,0,0,0,0,0
Kec. Indra Makmur Kab. Aceh Timur,0,0,0,0,0,0
Kec. Madat Kab. Aceh Timur,0,0,0,0,0,0
Kec. Darul Ihsan Kab. Aceh Timur,2,0,0,0,0,2
Kec. Peunaron Kab. Aceh Timur,1,1,0,0,0,2
Kec. Darul Falah Kab. Aceh Timur,0,0,0,0,0,0
Kec. Samalanga Kab. Bireuen,2,2,0,0,0,4
Kec. Pandrah Kab. Bireuen,0,0,0,0,0,0
Kec. Jeunib Kab. Bireuen,0,1,0,0,0,1
Kec. Peudada Kab. Bireuen,0,0,0,0,0,0
Kec. Juli Kab. Bireuen,0,0,0,0,0,0
Kec. Jeumpa Kab. Bireuen,4,0,0,0,0,4
Kec. Jangka Kab. Bireuen,0,0,0,0,0,0
Kec. Peusangan Kab. Bireuen,3,1,0,0,0,4
Kec. Makmur Kab. Bireuen,0,0,0,0,0,0
Kec. Ganda Pura Kab. Bireuen,2,0,0,0,0,2
Kec. Simpang Mamplam Kab. Bireuen,2,0,0,0,0,2
Kec. Peulimbang Kab. Bireuen,0,0,0,0,0,0
Kec. Kota Juang Kab. Bireuen,2,2,0,0,0,4
Kec. Kuala Kab. Bireuen,0,0,0,0,0,0
Kec. Peusangan Selatan Kab. Bireuen,0,0,0,0,0,0
Kec. Peusangan Siblah Krueng Kab. Bireuen,0,0,0,0,0,0
Kec. Kuta Blang Kab. Bireuen,0,0,0,0,0,0
Kec. Geumpang Kab. Pidie,0,0,0,0,0,0
Kec. Glumpang Tiga Kab. Pidie,3,1,0,0,0,4
Kec. Mutiara Kab. Pidie,0,0,0,0,0,0
Kec. Tangse Kab. Pidie,0,0,0,0,0,0
Kec. Sakti Kab. Pidie,2,0,0,0,0,2
Kec. Mila Kab. Pidie,0,0,0,0,0,0
Kec. Padang Tiji Kab. Pidie,1,1,0,0,0,2
Kec. Delima Kab. Pidie,4,0,0,0,0,4
Kec. Indrajaya Kab. Pidie,3,1,0,0,0,4
Kec. Peukan Baro Kab. Pidie,2,0,0,0,0,2
Kec. Kembang Tanjung Kab. Pidie,0,0,0,0,0,0
Kec. Simpang Tiga Kab. Pidie,0,0,0,0,0,0
Kec. Kota Sigli Kab. Pidie,3,1,0,0,0,4
Kec. Pidie Kab. Pidie,7,1,0,0,0,8
Kec. Muara Tiga Kab. Pidie,0,0,0,0,0,0
Kec. Grong-Grong Kab. Pidie,1,1,0,0,0,2
Kec. Mutiara Timur Kab. Pidie,2,0,0,0,0,2
Kec. Glumpang Baro Kab. Pidie,0,0,0,0,0,0
Kec. Keumala Kab. Pidie,4,0,0,0,0,4
Kec. Linge Kab. Aceh Tengah,0,0,0,0,0,0
Kec. Bintang Kab. Aceh Tengah,0,0,0,0,0,0
Kec. Pegasing Kab. Aceh Tengah,0,0,0,0,0,0
Kec. Bebesen Kab. Aceh Tengah,0,0,0,0,0,0
Kec. Silih Nara Kab. Aceh Tengah,0,0,0,0,0,0
Kec. Kute Panang Kab. Aceh Tengah,0,0,0,0,0,0
Kec. Ketol Kab. Aceh Tengah,0,0,0,0,0,0
Kec. Celala Kab. Aceh Tengah,0,0,0,0,0,0
Kec. Kebayakan Kab. Aceh Tengah,2,2,0,0,0,4
Kec. Laut Tawar Kab. Aceh Tengah,0,0,0,0,0,0
Kec. Atu Lintang Kab. Aceh Tengah,0,2,0,0,0,2
Kec. Jagong Jeget Kab. Aceh Tengah,0,0,0,0,0,0
Kec. Bies Kab. Aceh Tengah,0,0,0,0,0,0
Kec. Rusip Antara Kab. Aceh Tengah,0,0,0,0,0,0
Kec. Timang Gajah Kab. Bener Meriah,1,1,0,0,0,2
Kec. Bukit Kab. Bener Meriah,6,0,0,0,0,6
Kec. Bandar Kab. Bener Meriah,5,1,0,0,0,6
Kec. Permata Kab. Bener Meriah,2,0,0,0,0,2
Kec. Pintu Rime Gayo Kab. Bener Meriah,0,0,0,0,0,0
Kec. Wih Pesam Kab. Bener Meriah,2,0,0,0,0,2
Kec. Syiah Utama Kab. Bener Meriah,0,0,0,0,0,0
Kec. Bener Kelipah Kab. Bener Meriah,0,0,0,0,0,0
Kec. Mesidah Kab. Bener Meriah,0,0,0,0,0,0
Kec. Gajah Putih Kab. Bener Meriah,2,0,0,0,0,2
Kec. Teunom Kab. Aceh Jaya,0,0,0,0,0,0
Kec. Krueng Sabee Kab. Aceh Jaya,2,2,0,0,0,4
Kec. Setia Bakti Kab. Aceh Jaya,0,2,0,0,0,2
Kec. Sampoiniet Kab. Aceh Jaya,1,1,0,0,0,2
Kec. Jaya Kab. Aceh Jaya,2,0,0,0,0,2
Kec. Panga Kab. Aceh Jaya,2,0,0,0,0,2
Kec. Indra Jaya Kab. Aceh Jaya,0,0,0,0,0,0
Kec. Darul Hikmah Kab. Aceh Jaya,0,0,0,0,0,0
Kec. Pasie Raya Kab. Aceh Jaya,0,0,0,0,0,0
Kec. Manggeng Kab. Aceh Barat Daya,1,1,0,0,0,2
Kec. Tangan-Tangan Kab. Aceh Barat Daya,0,0,0,0,0,0
Kec. Blangpidie Kab. Aceh Barat Daya,1,1,0,0,0,2
Kec. Susoh Kab. Aceh Barat Daya,4,0,0,0,0,4
Kec. Kuala Batee Kab. Aceh Barat Daya,2,0,0,0,0,2
Kec. Babahrot Kab. Aceh Barat Daya,0,0,0,0,0,0
Kec. Lembah Sabil Kab. Aceh Barat Daya,2,0,0,0,0,2
Kec. Setia Kab. Aceh Barat Daya,0,0,0,0,0,0
Kec. Jeumpa Kab. Aceh Barat Daya,0,0,0,0,0,0
Kec. Blangkejeren Kab. Gayo Lues,2,0,0,0,0,2
Kec. Kutapanjang Kab. Gayo Lues,2,0,0,0,0,2
Kec. Rikit Gaib Kab. Gayo Lues,0,0,0,0,0,0
Kec. Terangun Kab. Gayo Lues,0,0,0,0,0,0
Kec. Pining Kab. Gayo Lues,0,0,0,0,0,0
Kec. Blangjerango Kab. Gayo Lues,0,0,0,0,0,0
Kec. Putri Betung Kab. Gayo Lues,0,0,0,0,0,0
Kec. Blang Pegayon Kab. Gayo Lues,1,1,0,0,0,2
Kec. Pantan Cuaca Kab. Gayo Lues,0,0,0,0,0,0
Kec. Tripe Jaya Kab. Gayo Lues,0,0,0,0,0,0
Kec. Pulau Banyak Kab. Aceh Singkil,0,0,0,0,0,0
Kec. Singkil Kab. Aceh Singkil,0,0,0,0,0,0
Kec. Simpang Kanan Kab. Aceh Singkil,0,0,0,0,0,0
Kec. Singkil Utara Kab. Aceh Singkil,0,2,0,0,0,2
Kec. Gunung Mariah Kab. Aceh Singkil,0,0,0,0,0,0
Kec. Danau Paris Kab. Aceh Singkil,2,0,0,0,0,2
Kec. Suro Makmur Kab. Aceh Singkil,0,0,0,0,0,0
Kec. Kuta Baharu Kab. Aceh Singkil,0,0,0,0,0,0
Kec. Singkohor Kab. Aceh Singkil,0,0,0,0,0,0
Kec. Pulau Banyak Barat Kab. Aceh Singkil,0,0,0,0,0,0
Kec. Tamiang Hulu Kab. Aceh Tamiang,1,1,0,0,0,2
Kec. Kejuruan Muda Kab. Aceh Tamiang,4,0,0,0,0,4
Kec. Kualasimpang Kab. Aceh Tamiang,1,1,0,0,0,2
Kec. Seruway Kab. Aceh Tamiang,3,1,0,0,0,4
Kec. Bendahara Kab. Aceh Tamiang,0,2,0,0,0,2
Kec. Karang Baru Kab. Aceh Tamiang,6,0,0,0,0,6
Kec. Manyak Payed Kab. Aceh Tamiang,2,2,0,0,0,4
Kec. Rantau Kab. Aceh Tamiang,10,0,0,0,0,10
Kec. Banda Mulya Kab. Aceh Tamiang,0,0,0,0,0,0
Kec. Bandar Pusaka Kab. Aceh Tamiang,0,0,0,0,0,0
Kec. Tenggulun Kab. Aceh Tamiang,0,0,0,0,0,0
Kec. Sekerak Kab. Aceh Tamiang,0,0,0,0,0,0
Kec. Darul Makmur Kab. Nagan Raya,7,3,0,0,0,10
Kec. Kuala Kab. Nagan Raya,3,1,0,0,0,4
Kec. Beutong Kab. Nagan Raya,4,0,0,0,0,4
Kec. Seunagan Kab. Nagan Raya,1,4,0,0,0,5
Kec. Seunagan Timur Kab. Nagan Raya,0,0,0,0,0,0
Kec. Kuala Pesisir Kab. Nagan Raya,1,1,0,0,0,2
Kec. Tadu Raya Kab. Nagan Raya,0,0,0,0,0,0
Kec. Suka Makmue Kab. Nagan Raya,0,0,0,0,0,0
Kec. Tripa Makmur Kab. Nagan Raya,0,0,0,0,0,0
Kec. Teupah Selatan Kab. Simeulue,1,1,0,0,0,2
Kec. Simeulue Timur Kab. Simeulue,2,2,0,0,0,4
Kec. Simeulue Tengah Kab. Simeulue,2,0,0,0,0,2
Kec. Salang Kab. Simeulue,0,0,0,0,0,0
Kec. Simeulue Barat Kab. Simeulue,0,0,0,0,0,0
Kec. Teupah Barat Kab. Simeulue,0,0,0,0,0,0
Kec. Teluk Dalam Kab. Simeulue,1,1,0,0,0,2
Kec. Alafan Kab. Simeulue,2,0,0,0,0,2
Kec. Teupah Tengah Kab. Simeulue,2,0,0,0,0,2
Kec. Simeulue Cut Kab. Simeulue,0,0,0,0,0,0
Kec. Johan Pahlawan Kab. Aceh Barat,4,4,0,0,0,8
Kec. Samatiga Kab. Aceh Barat,2,0,0,0,0,2
Kec. Woyla Kab. Aceh Barat,0,0,0,0,0,0
Kec. Kaway XVI Kab. Aceh Barat,2,0,0,0,0,2
Kec. Sungai Mas Kab. Aceh Barat,0,0,0,0,0,0
Kec. Bubon Kab. Aceh Barat,0,0,0,0,0,0
Kec. Arongan Lambalek Kab. Aceh Barat,0,0,0,0,0,0
Kec. Meureubo Kab. Aceh Barat,0,2,0,0,0,2
Kec. Pantee Ceureumen Kab. Aceh Barat,0,0,0,0,0,0
Kec. Woyla Barat Kab. Aceh Barat,0,0,0,0,0,0
Kec. Woyla Timur Kab. Aceh Barat,0,0,0,0,0,0
Kec. Panton Reu Kab. Aceh Barat,0,2,0,0,0,2
Kec. Meureudu Kab. Pidie Jaya,1,2,0,0,0,3
Kec. Ulim Kab. Pidie Jaya,0,0,0,0,0,0
Kec. Jangka Buya Kab. Pidie Jaya,0,2,0,0,0,2
Kec. Bandar Dua Kab. Pidie Jaya,0,0,0,0,0,0
Kec. Meurah Dua Kab. Pidie Jaya,2,0,0,0,0,2
Kec. Bandar Baru Kab. Pidie Jaya,2,2,0,0,0,4
Kec. Panteraja Kab. Pidie Jaya,0,2,0,0,0,2
Kec. Trienggadeng Kab. Pidie Jaya,0,0,0,0,0,0
Kec. Sukajaya Kota Sabang,1,1,0,0,0,2
Kec. Sukakarya Kota Sabang,3,1,0,0,0,4
Kec. Meuraxa Kota Banda Aceh,2,4,0,0,0,6
Kec. Baiturrahman Kota Banda Aceh,11,3,0,0,0,14
Kec. Kuta Alam Kota Banda Aceh,8,10,0,0,0,18
Kec. Syiah Kuala Kota Banda Aceh,4,0,0,0,0,4
Kec. Kuta Raja Kota Banda Aceh,2,2,0,0,0,4
Kec. Ulee Kareng Kota Banda Aceh,0,0,0,0,0,0
Kec. Lueng Bata Kota Banda Aceh,2,0,0,0,0,2
Kec. Banda Raya Kota Banda Aceh,4,0,0,0,0,4
Kec. Blang Mangat Kota Lhokseumawe,3,1,0,0,0,4
Kec. Muara Dua Kota Lhokseumawe,2,2,0,0,0,4
Kec. Banda Sakti Kota Lhokseumawe,4,2,0,0,0,6
Kec. Muara Satu Kota Lhokseumawe,4,2,0,0,0,6
Kec. Langsa Timur Kota Langsa,0,0,0,0,0,0
Kec. Langsa Barat Kota Langsa,1,1,0,0,0,2
Kec. Langsa Kota Kota Langsa,4,1,0,0,0,5
Kec. Langsa Baro Kota Langsa,6,0,0,0,0,6
Kec. Gunung Meriah Kab. Deli Serdang,0,0,0,0,0,0
Kec. Sinembah Tnjng Muda Hulu Kab. Deli Serdang,2,0,0,0,0,2
Kec. Sibolangit Kab. Deli Serdang,3,1,0,0,0,4
Kec. KutaIimbaru Kab. Deli Serdang,5,1,0,0,0,6
Kec. Pancur Batu Kab. Deli Serdang,11,1,0,0,0,12
Kec. Namo Rambe Kab. Deli Serdang,9,1,0,0,0,10
Kec. Sibiru-biru Kab. Deli Serdang,6,0,0,0,0,6
Kec. Bangun Purba Kab. Deli Serdang,2,2,0,0,0,4
Kec. Galang Kab. Deli Serdang,5,1,0,0,0,6
Kec. Tanjung Morawa Kab. Deli Serdang,13,1,0,0,0,14
Kec. Patumbak Kab. Deli Serdang,3,1,0,0,0,4
Kec. Deli Tua Kab. Deli Serdang,8,4,0,0,0,12
Kec. Sunggal Kab. Deli Serdang,14,3,0,0,0,17
Kec. Hamparan Perak Kab. Deli Serdang,6,2,0,0,0,8
Kec. Labuhan Deli Kab. Deli Serdang,10,0,0,0,0,10
Kec. Percut Sei Tuan Kab. Deli Serdang,32,4,0,0,0,36
Kec. Batang Kuis Kab. Deli Serdang,6,2,0,0,0,8
Kec. Pantai Labu Kab. Deli Serdang,2,0,0,0,0,2
Kec. Beringin Kab. Deli Serdang,6,1,0,0,0,7
Kec. Lubuk Pakam Kab. Deli Serdang,10,4,0,0,0,14
Kec. Pagar Marbau Kab. Deli Serdang,0,2,0,0,0,2
Kec. Stm Hilir Kab. Deli Serdang,0,0,0,0,0,0
Kec. Bilah Hulu Kab. Labuhan Batu,6,0,0,0,0,6
Kec. Pangkatan Kab. Labuhan Batu,0,0,0,0,0,0
Kec. Bilah Barat Kab. Labuhan Batu,1,1,0,0,0,2
Kec. Bilah Hilir Kab. Labuhan Batu,0,2,0,0,0,2
Kec. Panai Hulu Kab. Labuhan Batu,3,1,0,0,0,4
Kec. Panai Tengah Kab. Labuhan Batu,1,1,0,0,0,2
Kec. Panai Hilir Kab. Labuhan Batu,0,0,0,0,0,0
Kec. Rantau Selatan Kab. Labuhan Batu,4,0,0,0,0,4
Kec. Rantau Utara Kab. Labuhan Batu,12,4,0,0,0,16
Kec. Parmonangan Kab. Tapanuli Utara,0,0,0,0,0,0
Kec. Adian Koting Kab. Tapanuli Utara,1,1,0,0,0,2
Kec. Sipoholon Kab. Tapanuli Utara,0,0,0,0,0,0
Kec. Tarutung Kab. Tapanuli Utara,2,0,0,0,0,2
Kec. Pahae Jae Kab. Tapanuli Utara,0,0,0,0,0,0
Kec. Pahae Julu Kab. Tapanuli Utara,0,0,0,0,0,0
Kec. Pangaribuan Kab. Tapanuli Utara,1,1,0,0,0,2
Kec. Garoga Kab. Tapanuli Utara,0,0,0,0,0,0
Kec. Sipahutar Kab. Tapanuli Utara,0,0,0,0,0,0
Kec. Siborongborong Kab. Tapanuli Utara,4,0,0,0,0,4
Kec. Pagaran Kab. Tapanuli Utara,0,0,0,0,0,0
Kec. Muara Kab. Tapanuli Utara,0,0,0,0,0,0
Kec. Purbatua Kab. Tapanuli Utara,0,0,0,0,0,0
Kec. Simangumban Kab. Tapanuli Utara,0,0,0,0,0,0
Kec. Sibabangun Kab. Tapanuli Tengah,1,1,0,0,0,2
Kec. Pandan Kab. Tapanuli Tengah,4,2,0,0,0,6
Kec. Kolang Kab. Tapanuli Tengah,1,1,0,0,0,2
Kec. Sorkam Kab. Tapanuli Tengah,0,0,0,0,0,0
Kec. Barus Kab. Tapanuli Tengah,0,0,0,0,0,0
Kec. Manduamas Kab. Tapanuli Tengah,0,0,0,0,0,0
Kec. Sosor Gadong Kab. Tapanuli Tengah,0,0,0,0,0,0
Kec. Sorkam Barat Kab. Tapanuli Tengah,1,1,0,0,0,2
Kec. Andam Dewi Kab. Tapanuli Tengah,0,0,0,0,0,0
Kec. Badiri Kab. Tapanuli Tengah,0,0,0,0,0,0
Kec. Sitahuis Kab. Tapanuli Tengah,0,0,0,0,0,0
Kec. Sirandorung Kab. Tapanuli Tengah,0,0,0,0,0,0
Kec. Tukka Kab. Tapanuli Tengah,0,0,0,0,0,0
Kec. Pinang Sori Kab. Tapanuli Tengah,4,0,0,0,0,4
Kec. Sarudik Kab. Tapanuli Tengah,0,0,0,0,0,0
Kec. Pasaribu Tobing Kab. Tapanuli Tengah,0,0,0,0,0,0
Kec. Salak Kab. Pakpak Bharat,0,0,0,0,0,0
Kec. Kerajaan Kab. Pakpak Bharat,0,0,0,0,0,0
Kec. Sitelutali Urang Jehe Kab. Pakpak Bharat,0,0,0,0,0,0
Kec. Tinada Kab. Pakpak Bharat,0,0,0,0,0,0
Kec. Sitelu Tali Urang Julu Kab. Pakpak Bharat,0,0,0,0,0,0
Kec. Pakkat Kab. Humbang Hasudutan,0,0,0,0,0,0
Kec. Onan Ganjang Kab. Humbang Hasudutan,1,1,0,0,0,2
Kec. Lintong Nihuta Kab. Humbang Hasudutan,0,0,0,0,0,0
Kec. Dolok Sanggul Kab. Humbang Hasudutan,1,1,0,0,0,2
Kec. Parlilitan Kab. Humbang Hasudutan,0,0,0,0,0,0
Kec. Pollung Kab. Humbang Hasudutan,2,0,0,0,0,2
Kec. Paranginan Kab. Humbang Hasudutan,0,0,0,0,0,0
Kec. Bakti Raja Kab. Humbang Hasudutan,0,0,0,0,0,0
Kec. Sijamapolang Kab. Humbang Hasudutan,0,0,0,0,0,0
Kec. Tarabintang Kab. Humbang Hasudutan,0,0,0,0,0,0
Kec. Mardingding Kab. Karo,3,1,0,0,0,4
Kec. Laubaleng Kab. Karo,0,0,0,0,0,0
Kec. Tigabinanga Kab. Karo,0,0,0,0,0,0
Kec. Juhar Kab. Karo,0,0,0,0,0,0
Kec. Munte Kab. Karo,0,0,0,0,0,0
Kec. Kutabuluh Kab. Karo,0,0,0,0,0,0
Kec. Simpangempat Kab. Karo,2,0,0,0,0,2
Kec. Kabanjahe Kab. Karo,12,0,0,0,0,12
Kec. Berastagi Kab. Karo,4,2,0,0,0,6
Kec. Tigapanah Kab. Karo,2,0,0,0,0,2
Kec. Merek Kab. Karo,1,1,0,0,0,2
Kec. Barusjahe Kab. Karo,0,2,0,0,0,2
Kec. Tiganderket Kab. Karo,0,0,0,0,0,0
Kec. Silimakuta Kab. Simalungun,0,2,0,0,0,2
Kec. Purba Kab. Simalungun,0,0,0,0,0,0
Kec. Dolok Pardamean Kab. Simalungun,0,0,0,0,0,0
Kec. Sidamanik Kab. Simalungun,0,0,0,0,0,0
Kec. Girsang Simpangan Bolon Kab. Simalungun,0,0,0,0,0,0
Kec. Tanah Jawa Kab. Simalungun,9,1,0,0,0,10
Kec. Dolok Panribuan Kab. Simalungun,0,0,0,0,0,0
Kec. Panei Kab. Simalungun,0,0,0,0,0,0
Kec. Raya Kab. Simalungun,7,1,0,0,0,8
Kec. Dolok Silau Kab. Simalungun,0,0,0,0,0,0
Kec. Silau Kahean Kab. Simalungun,0,0,0,0,0,0
Kec. Raya Kahean Kab. Simalungun,0,0,0,0,0,0
Kec. Tapian Dolok Kab. Simalungun,1,1,0,0,0,2
Kec. Dolok Batu Nanggar Kab. Simalungun,2,2,0,0,0,4
Kec. Siantar Kab. Simalungun,3,1,0,0,0,4
Kec. Hutabayu Raja Kab. Simalungun,3,1,0,0,0,4
Kec. Pematang Bandar Kab. Simalungun,0,0,0,0,0,0
Kec. Bandar Kab. Simalungun,8,0,0,0,0,8
Kec. Bosar Maligas Kab. Simalungun,0,0,0,0,0,0
Kec. Ujung Padang Kab. Simalungun,0,0,0,0,0,0
Kec. Panombeian Panei Kab. Simalungun,2,0,0,0,0,2
Kec. Gunung Malela Kab. Simalungun,3,1,0,0,0,4
Kec. Bandar Huluan Kab. Simalungun,0,0,0,0,0,0
Kec. Jawa Maraja Bah Jambi Kab. Simalungun,2,0,0,0,0,2
Kec. Idanogawo Kab. Nias,0,0,0,0,0,0
Kec. Gido Kab. Nias,4,0,0,0,0,4
Kec. Hiliduho Kab. Nias,0,0,0,0,0,0
Kec. Bawolato Kab. Nias,0,0,0,0,0,0
Kec. Ulugawo Kab. Nias,0,0,0,0,0,0
Kec. Mau Kab. Nias,0,0,0,0,0,0
Kec. Hiliserangkai Kab. Nias,0,0,0,0,0,0
Kec. Botomuzoi Kab. Nias,0,0,0,0,0,0
Kec. Medang Deras Kab. Batubara,2,0,0,0,0,2
Kec. Air Putih Kab. Batubara,2,0,0,0,0,2
Kec. Lima Puluh Kab. Batubara,2,2,0,0,0,4
Kec. Sei Balai Kab. Batubara,5,3,0,0,0,8
Kec. Sei Suka Kab. Batubara,5,1,0,0,0,6
Kec. Talawi Kab. Batubara,2,0,0,0,0,2
Kec. Tanjung Tiram Kab. Batubara,3,1,0,0,0,4
Kec. Padang Bolak Julu Kab. Padang Lawas utara,2,0,0,0,0,2
Kec. Padang Bolak Kab. Padang Lawas utara,0,0,0,0,0,0
Kec. Halongonan Kab. Padang Lawas utara,0,0,0,0,0,0
Kec. Dolok Sigompulon Kab. Padang Lawas utara,0,0,0,0,0,0
Kec. Portibi Kab. Padang Lawas utara,0,0,0,0,0,0
Kec. Simangambat Kab. Padang Lawas utara,1,1,0,0,0,2
Kec. Batang Onang Kab. Padang Lawas utara,0,0,0,0,0,0
Kec. Dolok Kab. Padang Lawas utara,0,0,0,0,0,0
Kec. Sidikalang Kab. Dairi,2,2,0,0,0,4
Kec. Parbuluan Kab. Dairi,0,0,0,0,0,0
Kec. Sumbul Kab. Dairi,0,0,0,0,0,0
Kec. Pegangan Hilir Kab. Dairi,0,0,0,0,0,0
Kec. Siempat Nempu Hulu Kab. Dairi,0,0,0,0,0,0
Kec. Siempat Nempu Kab. Dairi,4,0,0,0,0,4
Kec. Silima Pungga-Pungga Kab. Dairi,0,0,0,0,0,0
Kec. Siempat Nempu Hilir Kab. Dairi,0,0,0,0,0,0
Kec. Tigalingga Kab. Dairi,0,0,0,0,0,0
Kec. Tanah Pinem Kab. Dairi,0,0,0,0,0,0
Kec. Lae Parira Kab. Dairi,0,0,0,0,0,0
Kec. Sitinjo Kab. Dairi,0,0,0,0,0,0
Kec. Silahi Sabungan Kab. Dairi,0,0,0,0,0,0
Kec. Balige Kab. Toba Samosir,6,2,0,0,0,8
Kec. Lagu Boti Kab. Toba Samosir,1,1,0,0,0,2
Kec. Habinsaran Kab. Toba Samosir,2,0,0,0,0,2
Kec. Silaen Kab. Toba Samosir,0,0,0,0,0,0
Kec. Lumban Julu Kab. Toba Samosir,0,0,0,0,0,0
Kec. Uluan Kab. Toba Samosir,0,0,0,0,0,0
Kec. Pintu Pohan Meranti Kab. Toba Samosir,1,1,0,0,0,2
Kec. Ajibata Kab. Toba Samosir,0,0,0,0,0,0
Kec. Borbor Kab. Toba Samosir,0,0,0,0,0,0
Kec. Tampahan Kab. Toba Samosir,0,0,0,0,0,0
Kec. Siantar Narumonda Kab. Toba Samosir,0,0,0,0,0,0
Kec. Parmaksian Kab. Toba Samosir,2,0,0,0,0,2
Kec. Tuhemberua Kab. Nias Utara,0,0,0,0,0,0
Kec. Lotu Kab. Nias Utara,0,0,0,0,0,0
Kec. Sitolu Ori Kab. Nias Utara,1,1,0,0,0,2
Kec. Sawo Kab. Nias Utara,0,0,0,0,0,0
Kec. Alasa Kab. Nias Utara,0,0,0,0,0,0
Kec. Namohalu Esiwa Kab. Nias Utara,0,0,0,0,0,0
Kec. Alasa Talumuzoi Kab. Nias Utara,0,0,0,0,0,0
Kec. Tugala Oyo Kab. Nias Utara,0,0,0,0,0,0
Kec. Lahewa Kab. Nias Utara,0,0,0,0,0,0
Kec. Afulu Kab. Nias Utara,0,0,0,0,0,0
Kec. Lahewa Timur Kab. Nias Utara,0,0,0,0,0,0
Kec. Medan Tuntungan Kota Medan,13,1,0,0,0,14
Kec. Medan Johor Kota Medan,30,2,0,0,0,32
Kec. Medan Amplas Kota Medan,10,2,0,0,0,12
Kec. Medan Denai Kota Medan,13,1,0,0,0,14
Kec. Medan Area Kota Medan,11,6,0,0,0,17
Kec. Medan Kota Kota Medan,31,10,0,0,0,41
Kec. Medan Maimun Kota Medan,6,0,0,0,0,6
Kec. Medan Polonia Kota Medan,13,2,0,0,0,15
Kec. Medan Baru Kota Medan,12,6,0,0,0,18
Kec. Medan Selayang Kota Medan,17,3,0,0,0,20
Kec. Medan Sunggal Kota Medan,17,3,0,0,0,20
Kec. Medan Helvetia Kota Medan,17,5,0,0,0,22
Kec. Medan Petisah Kota Medan,11,5,0,0,0,16
Kec. Medan Barat Kota Medan,14,2,0,0,0,16
Kec. Medan Timur Kota Medan,15,2,0,0,0,17
Kec. Medan Perjuangan Kota Medan,5,1,0,0,0,6
Kec. Medan Tembung Kota Medan,17,3,0,0,0,20
Kec. Medan Deli Kota Medan,8,2,0,0,0,10
Kec. Medan Labuhan Kota Medan,7,1,0,0,0,8
Kec. Medan Marelan Kota Medan,14,2,0,0,0,16
Kec. Medan Kota Belawan Kota Medan,2,0,0,0,0,2
Kec. Binjai Selatan Kota Binjai,12,0,0,0,0,12
Kec. Binjai Kota Kota Binjai,12,2,0,0,0,14
Kec. Binjai Timur Kota Binjai,2,2,0,0,0,4
Kec. Binjai Utara Kota Binjai,11,5,0,0,0,16
Kec. Binjai Barat Kota Binjai,4,2,0,0,0,6
Kec. Batahan Kab. Mandailing Natal,0,0,0,0,0,0
Kec. Batang Natal Kab. Mandailing Natal,0,0,0,0,0,0
Kec. Kotanopan Kab. Mandailing Natal,2,0,0,0,0,2
Kec. Muara Sipongi Kab. Mandailing Natal,2,0,0,0,0,2
Kec. Panyabungan Kota Kab. Mandailing Natal,6,2,0,0,0,8
Kec. Natal Kab. Mandailing Natal,0,0,0,0,0,0
Kec. Muara Batang Gadis Kab. Mandailing Natal,2,0,0,0,0,2
Kec. Siabu Kab. Mandailing Natal,2,2,0,0,0,4
Kec. Panyabungan Utara Kab. Mandailing Natal,0,0,0,0,0,0
Kec. Panyabungan Timur Kab. Mandailing Natal,0,0,0,0,0,0
Kec. Panyabungan Selatan Kab. Mandailing Natal,0,0,0,0,0,0
Kec. Tambangan Kab. Mandailing Natal,0,2,0,0,0,2
Kec. Lingga Bayu Kab. Mandailing Natal,0,0,0,0,0,0
Kec. Ranto Baek Kab. Mandailing Natal,0,0,0,0,0,0
Kec. Sinunukan Kab. Mandailing Natal,1,1,0,0,0,2
Kec. Huta Bargot Kab. Mandailing Natal,0,0,0,0,0,0
Kec. Naga Juang Kab. Mandailing Natal,2,0,0,0,0,2
Kec. Barumun Kab. Padang Lawas,4,0,0,0,0,4
Kec. Sosa Kab. Padang Lawas,0,0,0,0,0,0
Kec. Barumun Tengah Kab. Padang Lawas,0,2,0,0,0,2
Kec. Huta Raja Tinggi Kab. Padang Lawas,0,0,0,0,0,0
Kec. Ulu Barumun Kab. Padang Lawas,6,0,0,0,0,6
Kec. Sosopan Kab. Padang Lawas,0,0,0,0,0,0
Kec. Barumun Selatan Kab. Padang Lawas,0,0,0,0,0,0
Kec. Sihapas Barumun Kab. Padang Lawas,0,0,0,0,0,0
Kec. Na. IX-X Kab. Labuhan Batu Utara,0,0,0,0,0,0
Kec. Aek Natas Kab. Labuhan Batu Utara,0,0,0,0,0,0
Kec. Aek Kuo Kab. Labuhan Batu Utara,0,0,0,0,0,0
Kec. Kualuh Hilir Kab. Labuhan Batu Utara,0,0,0,0,0,0
Kec. Kualuh Selatan Kab. Labuhan Batu Utara,1,1,0,0,0,2
Kec. Kualuh Hulu Kab. Labuhan Batu Utara,9,3,0,0,0,12
Kec. Kualuh Leidong Kab. Labuhan Batu Utara,2,0,0,0,0,2
Kec. Marbau Kab. Labuhan Batu Utara,1,1,0,0,0,2
Kec. Sungai Kanan Kab. Labuhan Batu Selatan,2,0,0,0,0,2
Kec. Torgamba Kab. Labuhan Batu Selatan,10,0,0,0,0,10
Kec. Kota Pinang Kab. Labuhan Batu Selatan,3,1,0,0,0,4
Kec. Silangkitang Kab. Labuhan Batu Selatan,1,1,0,0,0,2
Kec. Kampung Rakyat Kab. Labuhan Batu Selatan,2,0,0,0,0,2
Kec. Lolofitu Moi Kab. Nias Barat,0,0,0,0,0,0
Kec. Sirombu Kab. Nias Barat,0,0,0,0,0,0
Kec. Lahomi Kab. Nias Barat,0,0,0,0,0,0
Kec. Mandrehe Kab. Nias Barat,3,1,0,0,0,4
Kec. Moro o Kab. Nias Barat,0,0,0,0,0,0
Kec. Ulu Moro o Kab. Nias Barat,0,0,0,0,0,0
Kec. Mandrehe Utara Kab. Nias Barat,2,0,0,0,0,2
Kec. Bohorok Kab. Langkat,0,0,0,0,0,0
Kec. Salapian Kab. Langkat,3,1,0,0,0,4
Kec. Sei Bingai Kab. Langkat,0,0,0,0,0,0
Kec. Kuala Kab. Langkat,4,4,0,0,0,8
Kec. Selesai Kab. Langkat,7,1,0,0,0,8
Kec. Binjai Kab. Langkat,0,2,0,0,0,2
Kec. Stabat Kab. Langkat,10,2,0,0,0,12
Kec. Wampu Kab. Langkat,1,1,0,0,0,2
Kec. Batang Serangan Kab. Langkat,0,0,0,0,0,0
Kec. Sawit Seberang Kab. Langkat,4,0,0,0,0,4
Kec. Padang Tualang Kab. Langkat,2,0,0,0,0,2
Kec. Hinai Kab. Langkat,2,0,0,0,0,2
Kec. Secanggang Kab. Langkat,2,0,0,0,0,2
Kec. Tanjung Pura Kab. Langkat,5,1,0,0,0,6
Kec. Gebang Kab. Langkat,1,1,0,0,0,2
Kec. Sei Lepan Kab. Langkat,4,2,0,0,0,6
Kec. Babalan Kab. Langkat,2,2,0,0,0,4
Kec. Berandan Barat Kab. Langkat,0,0,0,0,0,0
Kec. Besitang Kab. Langkat,2,0,0,0,0,2
Kec. Pangkalan Susu Kab. Langkat,2,0,0,0,0,2
Kec. Serapit Kab. Langkat,1,1,0,0,0,2
Kec. Batang Angkola Kab. Tapanuli Selatan,0,0,0,0,0,0
Kec. Batang Toru Kab. Tapanuli Selatan,0,0,0,0,0,0
Kec. Sipirok Kab. Tapanuli Selatan,2,0,0,0,0,2
Kec. Arse Kab. Tapanuli Selatan,0,0,0,0,0,0
Kec. Saipar Dolok Hole Kab. Tapanuli Selatan,0,0,0,0,0,0
Kec. Marancar Kab. Tapanuli Selatan,0,0,0,0,0,0
Kec. Sayur Matinggi Kab. Tapanuli Selatan,0,0,0,0,0,0
Kec. Angkola Barat Kab. Tapanuli Selatan,0,0,0,0,0,0
Kec. Angkola Selatan Kab. Tapanuli Selatan,0,0,0,0,0,0
Kec. Angkola Timur Kab. Tapanuli Selatan,1,1,0,0,0,2
Kec. Tantom Angkola Kab. Tapanuli Selatan,0,0,0,0,0,0
Kec. Sianjur Mula Mula Kab. Samosir,0,0,0,0,0,0
Kec. Onanrunggu  Kab. Samosir,0,0,0,0,0,0
Kec. Palipi Kab. Samosir,0,0,0,0,0,0
Kec. Pangururan Kab. Samosir,2,4,0,0,0,6
Kec. Simanindo Kab. Samosir,0,0,0,0,0,0
Kec. Nainggolan Kab. Samosir,0,0,0,0,0,0
Kec. Ronggur Nihuta Kab. Samosir,1,1,0,0,0,2
Kec. Sitiotio Kab. Samosir,0,0,0,0,0,0
Kec. Kotarih Kab. Serdang Bedagai,2,0,0,0,0,2
Kec. Dolok Masihul Kab. Serdang Bedagai,3,1,0,0,0,4
Kec. Sipispis Kab. Serdang Bedagai,0,0,0,0,0,0
Kec. Dolok Merawan Kab. Serdang Bedagai,0,0,0,0,0,0
Kec. Tebing Tinggi Kab. Serdang Bedagai,2,0,0,0,0,2
Kec. Bandar Khalifah Kab. Serdang Bedagai,2,0,0,0,0,2
Kec. Tanjung Beringin Kab. Serdang Bedagai,0,0,0,0,0,0
Kec. Teluk Mengkudu Kab. Serdang Bedagai,0,0,0,0,0,0
Kec. Sei Rampah Kab. Serdang Bedagai,4,2,0,0,0,6
Kec. Perbaungan Kab. Serdang Bedagai,3,1,0,0,0,4
Kec. Pantai Cermin Kab. Serdang Bedagai,1,1,0,0,0,2
Kec. Silinda Kab. Serdang Bedagai,0,0,0,0,0,0
Kec. Bintang Bayu Kab. Serdang Bedagai,1,1,0,0,0,2
Kec. Serbajadi Kab. Serdang Bedagai,0,2,0,0,0,2
Kec. Tebing Syahbandar Kab. Serdang Bedagai,1,1,0,0,0,2
Kec. Sei Bamban Kab. Serdang Bedagai,2,0,0,0,0,2
Kec. Pegajahan Kab. Serdang Bedagai,1,1,0,0,0,2
Kec. Bandar Pasir Mandoge Kab. Asahan,2,0,0,0,0,2
Kec. Bandar Pulau Kab. Asahan,0,0,0,0,0,0
Kec. Pulau Rakyat Kab. Asahan,2,0,0,0,0,2
Kec. Tanjung Balai Kab. Asahan,2,0,0,0,0,2
Kec. Simpang Empat Kab. Asahan,0,0,0,0,0,0
Kec. Air Batu Kab. Asahan,2,0,0,0,0,2
Kec. Buntu Pane Kab. Asahan,2,2,0,0,0,4
Kec. Meranti Kab. Asahan,0,0,0,0,0,0
Kec. Air Joman Kab. Asahan,1,1,0,0,0,2
Kec. Aek Kuasan Kab. Asahan,0,0,0,0,0,0
Kec. Kisaran Barat Kab. Asahan,11,1,0,0,0,12
Kec. Kisaran Timur Kab. Asahan,7,1,0,0,0,8
Kec. Aek Songsongan Kab. Asahan,0,0,0,0,0,0
Kec. Sei Kepayang Barat Kab. Asahan,0,0,0,0,0,0
Kec. Sei dadap Kab. Asahan,0,0,0,0,0,0
Kec. Tinggi Raja Kab. Asahan,0,0,0,0,0,0
Kec. Setia Janji Kab. Asahan,1,1,0,0,0,2
Kec. Pulo Bandring Kab. Asahan,0,0,0,0,0,0
Kec. Rawang Panca Arga Kab. Asahan,0,0,0,0,0,0
Kec. Pulau-Pulau Batu Kab. Nias Selatan,0,0,0,0,0,0
Kec. Teluk Dalam Kab. Nias Selatan,2,0,0,0,0,2
Kec. Amandraya Kab. Nias Selatan,2,0,0,0,0,2
Kec. Lahusa Kab. Nias Selatan,0,0,0,0,0,0
Kec. Gomo Kab. Nias Selatan,1,1,0,0,0,2
Kec. Lolomatua Kab. Nias Selatan,0,0,0,0,0,0
Kec. Lolowau Kab. Nias Selatan,0,0,0,0,0,0
Kec. Hibala Kab. Nias Selatan,0,0,0,0,0,0
Kec. Susua Kab. Nias Selatan,0,0,0,0,0,0
Kec. Maniamolo Kab. Nias Selatan,2,2,0,0,0,4
Kec. Hilimegai Kab. Nias Selatan,0,0,0,0,0,0
Kec. Toma Kab. Nias Selatan,1,1,0,0,0,2
Kec. Mazino Kab. Nias Selatan,4,0,0,0,0,4
Kec. Umbunasi Kab. Nias Selatan,0,0,0,0,0,0
Kec. Aramo Kab. Nias Selatan,0,0,0,0,0,0
Kec. Mazo Kab. Nias Selatan,0,0,0,0,0,0
Kec. Fanayama Kab. Nias Selatan,0,0,0,0,0,0
Kec. Ulunoyo Kab. Nias Selatan,2,0,0,0,0,2
Kec. Huruna Kab. Nias Selatan,0,0,0,0,0,0
Kec. Oou Kab. Nias Selatan,0,0,0,0,0,0
Kec. Onohazumba Kab. Nias Selatan,2,0,0,0,0,2
Kec. Hilisalawaahe Kab. Nias Selatan,0,0,0,0,0,0
Kec. Ulususua Kab. Nias Selatan,0,0,0,0,0,0
Kec. Siduaori Kab. Nias Selatan,0,0,0,0,0,0
Kec. Somambawa Kab. Nias Selatan,0,0,0,0,0,0
Kec. Boronadu Kab. Nias Selatan,0,0,0,0,0,0
Kec. Ulu Idanotae Kab. Nias Selatan,0,0,0,0,0,0
Kec. Idanotae Kab. Nias Selatan,2,0,0,0,0,2
Kec. Pulau-pulau Batu Barat Kab. Nias Selatan,0,0,0,0,0,0
Kec. Simuk Kab. Nias Selatan,0,0,0,0,0,0
Kec. Tanah Masa Kab. Nias Selatan,0,0,0,0,0,0
Kec. Onolalu Kab. Nias Selatan,0,0,0,0,0,0
Kec. Luahagundre Maniamolo Kab. Nias Selatan,0,0,0,0,0,0
Kec. Padang Hulu Kota Tebing Tinggi,2,0,0,0,0,2
Kec. Rambutan Kota Tebing Tinggi,6,2,0,0,0,8
Kec. Padang Hilir Kota Tebing Tinggi,4,0,0,0,0,4
Kec. Bajenis Kota Tebing Tinggi,0,0,0,0,0,0
Kec. Tebing Tinggi Kota Kota Tebing Tinggi,10,4,0,0,0,14
Kec. Siantar Marihat Kota Pematangsiantar,4,2,0,0,0,6
Kec. Siantar Selatan Kota Pematangsiantar,4,0,0,0,0,4
Kec. Siantar Barat Kota Pematangsiantar,6,4,0,0,0,10
Kec. Siantar Utara Kota Pematangsiantar,12,0,0,0,0,12
Kec. Siantar Timur Kota Pematangsiantar,6,4,0,0,0,10
Kec. Siantar Martoba Kota Pematangsiantar,3,1,0,0,0,4
Kec. Siantar Marimbun Kota Pematangsiantar,2,0,0,0,0,2
Kec. Siantar Sitalasari Kota Pematangsiantar,2,0,0,0,0,2
Kec. Datuk Bandar Kota Tanjung Balai,4,0,0,0,0,4
Kec. Tanjung Balai Selatan Kota Tanjung Balai,4,0,0,0,0,4
Kec. S. Tualang Raso Kota Tanjung Balai,4,0,0,0,0,4
Kec. Teluk Nibung Kota Tanjung Balai,0,2,0,0,0,2
Kec. Sibolga Utara Kota Sibolga,1,1,0,0,0,2
Kec. Sibolga Kota Kota Sibolga,10,0,0,0,0,10
Kec. Sibolga Selatan Kota Sibolga,1,1,0,0,0,2
Kec. Padang Sidimpuan Selatan Kota Padang Sidimpuan,10,2,0,0,0,12
Kec. Padang Sidimpuan Utara Kota Padang Sidimpuan,7,3,0,0,0,10
Kec. Batu Nadua Kota Padang Sidimpuan,3,1,0,0,0,4
Kec. Hutaimbaru Kota Padang Sidimpuan,1,1,0,0,0,2
Kec. Padang Sidimpuan Tenggara Kota Padang Sidimpuan,0,0,0,0,0,0
Kec. Angkola Julu Kota Padang Sidimpuan,0,0,0,0,0,0
Kec. Gunungsitoli Idanoi Kota Gunungsitoli,0,0,0,0,0,0
Kec. Gunungsitoli Kota Gunungsitoli,7,5,0,0,0,12
Kec. Gunungsitoli Selatan Kota Gunungsitoli,2,0,0,0,0,2
Kec. Gunungsitoli Utara Kota Gunungsitoli,1,1,0,0,0,2
Kec. Bonjol Kab. Pasaman,3,1,0,0,0,4
Kec. Lubuk Sikaping Kab. Pasaman,6,0,0,0,0,6
Kec. II Koto Kab. Pasaman,0,2,0,0,0,2
Kec. Panti Kab. Pasaman,0,2,0,0,0,2
Kec.Tigo Nagari Kab. Pasaman,2,0,0,0,0,2
Kec. Rao Kab. Pasaman,10,0,0,0,0,10
Kec. Mapat Tunggul Kab. Pasaman,1,1,0,0,0,2
Kec. Mapat Tunggul Selatan Kab. Pasaman,2,0,0,0,0,2
Kec. Padang Gelugur Kab. Pasaman,1,1,0,0,0,2
Kec. Rao Utara Kab. Pasaman,0,0,0,0,0,0
Kec. Rao Selatan Kab. Pasaman,0,0,0,0,0,0
Kec. Payakumbuh Kab. Lima Puluh Koto,4,0,0,0,0,4
Kec. Luak Kab. Lima Puluh Koto,0,0,0,0,0,0
Kec. Harau Kab. Lima Puluh Koto,1,1,0,0,0,2
Kec. Guguak Kab. Lima Puluh Koto,1,1,0,0,0,2
Kec. Suliki Kab. Lima Puluh Koto,2,0,0,0,0,2
Kec. Gunuang Omeh Kab. Lima Puluh Koto,0,0,0,0,0,0
Kec. Kapur IX Kab. Lima Puluh Koto,2,0,0,0,0,2
Kec. Pangkalan Koto Baru Kab. Lima Puluh Koto,3,1,0,0,0,4
Kec. Bukik Barisan Kab. Lima Puluh Koto,0,0,0,0,0,0
Kec. Mungka Kab. Lima Puluh Koto,0,0,0,0,0,0
Kec. Akabiluru Kab. Lima Puluh Koto,0,0,0,0,0,0
Kec. Situjuah Limo Nagari Kab. Lima Puluh Koto,1,0,0,0,0,1
Kec. Lareh Sago Halaban Kab. Lima Puluh Koto,1,1,0,0,0,2
Kec. Pantai Cermin Kab. Solok,1,0,0,0,0,1
Kec. Lembah Gumanti Kab. Solok,2,1,0,0,0,3
Kec. Payung Sekaki Kab. Solok,0,0,0,0,0,0
Kec. Lembang Jaya Kab. Solok,3,1,0,0,0,4
Kec. Gunung Talang Kab. Solok,7,1,0,0,0,8
Kec. Bukit Sundi Kab. Solok,1,1,0,0,0,2
Kec. Kubung Kab. Solok,2,2,0,0,0,4
Kec. IX Koto Sungai Lasi Kab. Solok,2,0,0,0,0,2
Kec. X Koto Diatas Kab. Solok,2,0,0,0,0,2
Kec. X Koto Singkarak Kab. Solok,3,1,0,0,0,4
Kec. Junjung Sirih Kab. Solok,0,0,0,0,0,0
Kec. Hiliran Gumanti Kab. Solok,1,1,0,0,0,2
Kec. Tigo Lurah Kab. Solok,0,0,0,0,0,0
Kec. Danau Kembar Kab. Solok,0,0,0,0,0,0
Kec. Kamang Baru Kab. Sijunjung,9,0,0,0,0,9
Kec. Tanjung Gadang Kab. Sijunjung,2,0,0,0,0,2
Kec. Sijunjung Kab. Sijunjung,7,1,0,0,0,8
Kec. Kupitan Kab. Sijunjung,0,0,0,0,0,0
Kec. Koto VII Kab. Sijunjung,0,2,0,0,0,2
Kec. Sumpur Kudus Kab. Sijunjung,2,0,0,0,0,2
Kec. Lubuk Tarok Kab. Sijunjung,2,0,0,0,0,2
Kec. Pagai Utara Kab. Kepulauan Mentawai,0,0,0,0,0,0
Kec. Sipora Selatan Kab. Kepulauan Mentawai,0,0,0,0,0,0
Kec. Siberut Selatan Kab. Kepulauan Mentawai,2,2,0,0,0,4
Kec. Siberut Utara Kab. Kepulauan Mentawai,2,0,0,0,0,2
Kec. Siberut Barat Kab. Kepulauan Mentawai,0,0,0,0,0,0
Kec. Siberut Barat Daya Kab. Kepulauan Mentawai,0,0,0,0,0,0
Kec. Siberut Tengah Kab. Kepulauan Mentawai,0,0,0,0,0,0
Kec. Sipora Utara Kab. Kepulauan Mentawai,3,1,0,0,0,4
Kec. Sikakap Kab. Kepulauan Mentawai,1,1,0,0,0,2
Kec. Pagai Selatan Kab. Kepulauan Mentawai,0,0,0,0,0,0
Kec. Sangir Kab. Solok Selatan,5,1,0,0,0,6
Kec. Sungai Pagu Kab. Solok Selatan,4,0,0,0,0,4
Kec. Koto Parik Gadang Diateh Kab. Solok Selatan,0,2,0,0,0,2
Kec. Sangir Jujuan Kab. Solok Selatan,0,0,0,0,0,0
Kec. Sangir Batang Hari Kab. Solok Selatan,1,1,0,0,0,2
Kec. Pauh Duo Kab. Solok Selatan,0,0,0,0,0,0
Kec. Sangir Balai Janggo Kab. Solok Selatan,1,1,0,0,0,2
Kec. Sungai Rumbai Kab. Dharmasraya,4,0,0,0,0,4
Kec. Koto Baru Kab. Dharmasraya,7,1,0,0,0,8
Kec. Sitiung Kab. Dharmasraya,3,3,0,0,0,6
Kec. Pulau Punjung Kab. Dharmasraya,2,0,0,0,0,2
Kec. Sembilan Koto Kab. Dharmasraya,2,0,0,0,0,2
Kec. Timpeh Kab. Dharmasraya,2,0,0,0,0,2
Kec. Koto Salak Kab. Dharmasraya,4,0,0,0,0,4
Kec. Tiumang Kab. Dharmasraya,1,1,0,0,0,2
Kec. Asam Jujuhan Kab. Dharmasraya,0,0,0,0,0,0
Kec. Koto Besar Kab. Dharmasraya,2,0,0,0,0,2
Kec. Pariaman Selatan Kota Pariaman,4,2,0,0,0,6
Kec. Pariaman Tengah Kota Pariaman,8,0,0,0,0,8
Kec. Pariaman Utara Kota Pariaman,0,2,0,0,0,2
Kec. Pariaman Timur Kota Pariaman,1,1,0,0,0,2
Kec. Sungai Beremas Kab. Pasaman Barat,2,0,0,0,0,2
Kec. Ranah Batahan Kab. Pasaman Barat,1,1,0,0,0,2
Kec. Lembah Melintang Kab. Pasaman Barat,6,2,0,0,0,8
Kec. Gunung Tuleh Kab. Pasaman Barat,0,2,0,0,0,2
Kec. Pasaman Kab. Pasaman Barat,3,1,0,0,0,4
Kec. Kinali Kab. Pasaman Barat,1,3,0,0,0,4
Kec. Talamau Kab. Pasaman Barat,1,1,0,0,0,2
Kec. Koto Balingka Kab. Pasaman Barat,2,0,0,0,0,2
Kec. Luhak Nan Duo Kab. Pasaman Barat,1,1,0,0,0,2
Kec. Sasak Ranah Pesisir Kab. Pasaman Barat,2,0,0,0,0,2
Kec. Sungai Aur Kab. Pasaman Barat,2,0,0,0,0,2
Kec. Guguk Panjang Kota Bukittinggi,8,2,0,0,0,10
Kec. Mandiangin Koto Selayan Kota Bukittinggi,4,2,0,0,0,6
Kec. Aur Birugo Tigo Baleh Kota Bukittinggi,1,1,0,0,0,2
Kec. Bungus Teluk Kabung Kota Padang,4,0,0,0,0,4
Kec. Lubuk Kilangan Kota Padang,3,1,0,0,0,4
Kec. Lubuk Begalung Kota Padang,1,3,0,0,0,4
Kec. Padang Selatan Kota Padang,6,4,0,0,0,10
Kec. Padang Timur Kota Padang,8,4,0,0,0,12
Kec. Padang Barat Kota Padang,17,5,0,0,0,22
Kec. Padang Utara Kota Padang,18,4,0,0,0,22
Kec. Nanggalo Kota Padang,5,2,0,0,0,7
Kec. Kuranji Kota Padang,5,4,0,0,0,9
Kec. Pauh Kota Padang,4,0,0,0,0,4
Kec. Koto Tangah Kota Padang,6,4,0,0,0,10
Kec. Padang Panjang Barat Kota Padang Panjang,2,0,0,0,0,2
Kec. Padang Panjang Timur Kota Padang Panjang,10,4,0,0,0,14
Kec. Silungkang Kota Sawah Lunto,6,0,0,0,0,6
Kec. Lembah Segar Kota Sawah Lunto,3,1,0,0,0,4
Kec. Barangin Kota Sawah Lunto,0,0,0,0,0,0
Kec. Talawi Kota Sawah Lunto,2,0,0,0,0,2
Kec. Lubuk Sikarah Kota Solok,4,0,0,0,0,4
Kec. Tanjung Harapan Kota Solok,5,1,0,0,0,6
Kec. Payakumbuh Barat Kota Payakumbuh,2,2,0,0,0,4
Kec. Payakumbuh Timur Kota Payakumbuh,4,0,0,0,0,4
Kec. Payakumbuh Utara Kota Payakumbuh,9,1,0,0,0,10
Kec. Payakumbuh Selatan Kota Payakumbuh,0,0,0,0,0,0
Kec. Batang Anai Kab. Padang Pariaman,2,1,0,0,0,3
Kec. Lubuk Alung Kab. Padang Pariaman,4,0,0,0,0,4
Kec. Ulakan Tapakis Kab. Padang Pariaman,0,0,0,0,0,0
Kec. Nan Sabaris Kab. Padang Pariaman,1,1,0,0,0,2
Kec. 2 x 11 VI Lingkung Kab. Padang Pariaman,1,0,0,0,0,1
Kec. VII Koto Sungai Sarik Kab. Padang Pariaman,2,0,0,0,0,2
Kec. V Koto Kampung Dalam Kab. Padang Pariaman,4,0,0,0,0,4
Kec. Sungai Limau Kab. Padang Pariaman,3,1,0,0,0,4
Kec. Sungai Geringging Kab. Padang Pariaman,1,1,0,0,0,2
Kec. IV Koto Aur Malintang Kab. Padang Pariaman,1,1,0,0,0,2
Kec. Batang Gasan Kab. Padang Pariaman,0,0,0,0,0,0
Kec. V Koto Timur Kab. Padang Pariaman,2,0,0,0,0,2
Kec. Patamuan Kab. Padang Pariaman,0,0,0,0,0,0
Kec. Padang Sago Kab. Padang Pariaman,0,0,0,0,0,0
Kec. 2 x 11 Kayu Tanam Kab. Padang Pariaman,6,0,0,0,0,6
Kec. VI Lingkung Kab. Padang Pariaman,4,0,0,0,0,4
Kec. Lunang Kab. Pesisir Selatan,0,0,0,0,0,0
Kec. Basa Ampek Balai Tapan Kab. Pesisir Selatan,1,1,0,0,0,2
Kec. Pancung Soal Kab. Pesisir Selatan,1,1,0,0,0,2
Kec. Linggo Saribaganti Kab. Pesisir Selatan,2,0,0,0,0,2
Kec. Ranah Pesisir Kab. Pesisir Selatan,2,2,0,0,0,4
Kec. Lengayang Kab. Pesisir Selatan,0,2,0,0,0,2
Kec. Sutera Kab. Pesisir Selatan,2,1,0,0,0,3
Kec. Batang Kapas Kab. Pesisir Selatan,1,1,0,0,0,2
Kec. IV Jurai Kab. Pesisir Selatan,5,1,0,0,0,6
Kec. Bayang Kab. Pesisir Selatan,0,2,0,0,0,2
Kec. Koto XI Terusan Kab. Pesisir Selatan,0,0,0,0,0,0
Kec. Bayang Utara Kab. Pesisir Selatan,2,0,0,0,0,2
Kec. Silaut Kab. Pesisir Selatan,2,0,0,0,0,2
Kec. Air Pura Kab. Pesisir Selatan,0,0,0,0,0,0
Kec. X Koto Kab. Tanah Datar,5,1,0,0,0,6
Kec. Batipuh Kab. Tanah Datar,2,0,0,0,0,2
Kec. Pariangan Kab. Tanah Datar,4,0,0,0,0,4
Kec. Rambatan Kab. Tanah Datar,0,2,0,0,0,2
Kec. Lima Kaum Kab. Tanah Datar,3,3,0,0,0,6
Kec. Tanjung Emas Kab. Tanah Datar,2,0,0,0,0,2
Kec. Padang Ganting Kab. Tanah Datar,2,0,0,0,0,2
Kec. Lintau Buo Kab. Tanah Datar,0,0,0,0,0,0
Kec. Sungayang Kab. Tanah Datar,2,0,0,0,0,2
Kec. Sungai Tarab Kab. Tanah Datar,2,0,0,0,0,2
Kec. Salimpaung Kab. Tanah Datar,2,0,0,0,0,2
Kec. Lintau Buo Utara Kab. Tanah Datar,0,2,0,0,0,2
Kec. Tanjung Mutiara Kab. Agam,2,0,0,0,0,2
Kec. Lubuk Basung Kab. Agam,5,3,0,0,0,8
Kec. Tanjung Raya Kab. Agam,5,1,0,0,0,6
Kec. Matur Kab. Agam,1,1,0,0,0,2
Kec. IV Koto Kab. Agam,5,1,0,0,0,6
Kec. Baso Kab. Agam,1,1,0,0,0,2
Kec. Tilatang Kamang Kab. Agam,2,2,0,0,0,4
Kec. Palembayan Kab. Agam,2,0,0,0,0,2
Kec. Palupuh Kab. Agam,0,0,0,0,0,0
Kec. Sungai Pua Kab. Agam,1,1,0,0,0,2
Kec. Candung Kab. Agam,1,1,0,0,0,2
Kec. Kamang Magek Kab. Agam,2,0,0,0,0,2
Kec. Banuhampu Kab. Agam,4,0,0,0,0,4
Kec. Ampek Angkek Kab. Agam,3,1,0,0,0,4
Kec. Ampek Nagari Kab. Agam,2,0,0,0,0,2
Kec. Langgam Kab. Pelalawan,2,0,0,0,0,2
Kec. Pangkalan Kuras Kab. Pelalawan,2,0,0,0,0,2
Kec. Bunut Kab. Pelalawan,6,0,0,0,0,6
Kec. Kuala Kampar Kab. Pelalawan,1,1,0,0,0,2
Kec. Pangkalan Kerinci Kab. Pelalawan,11,1,0,0,0,12
Kec. Ukui Kab. Pelalawan,0,0,0,0,0,0
Kec. Pangkalan Lesung Kab. Pelalawan,2,0,0,0,0,2
Kec. Kerumutan Kab. Pelalawan,0,0,0,0,0,0
Kec. Pelalawan Kab. Pelalawan,0,0,0,0,0,0
Kec. Teluk Meranti Kab. Pelalawan,1,1,0,0,0,2
Kec. Bandar Sei Kijang Kab. Pelalawan,6,0,0,0,0,6
Kec. Bandar Petalangan Kab. Pelalawan,0,0,0,0,0,0
Kec. Ujung Batu Kab. Rokan Hulu,2,2,0,0,0,4
Kec. Rokan IV Koto Kab. Rokan Hulu,0,2,0,0,0,2
Kec. Rambah Kab. Rokan Hulu,3,1,0,0,0,4
Kec. Tambusai Kab. Rokan Hulu,6,0,0,0,0,6
Kec. Kepenuhan Kab. Rokan Hulu,0,2,0,0,0,2
Kec. Kunto Darussalam Kab. Rokan Hulu,4,2,0,0,0,6
Kec. Rambah Samo Kab. Rokan Hulu,2,0,0,0,0,2
Kec. Rambah Hilir Kab. Rokan Hulu,5,1,0,0,0,6
Kec. Tambusai Utara Kab. Rokan Hulu,4,2,0,0,0,6
Kec. Bangun Purba Kab. Rokan Hulu,2,0,0,0,0,2
Kec. Tandun Kab. Rokan Hulu,6,0,0,0,0,6
Kec. Kabun Kab. Rokan Hulu,0,0,0,0,0,0
Kec. Bonai Darussalam Kab. Rokan Hulu,0,0,0,0,0,0
Kec. Pagaran Tapah Darussalam Kab. Rokan Hulu,2,0,0,0,0,2
Kec. Pendalian IV Koto Kab. Rokan Hulu,1,1,0,0,0,2
Kec. Kepenuhan Hulu Kab. Rokan Hulu,0,0,0,0,0,0
Kec. Kuantan Mudik Kab. Kuantan Singingi,4,0,0,0,0,4
Kec. Kuantan Tengah Kab. Kuantan Singingi,5,3,0,0,0,8
Kec. Benai Kab. Kuantan Singingi,3,1,0,0,0,4
Kec. Singingi Kab. Kuantan Singingi,4,0,0,0,0,4
Kec. Kuantan Hilir Kab. Kuantan Singingi,1,1,0,0,0,2
Kec. Cerenti Kab. Kuantan Singingi,0,0,0,0,0,0
Kec. Pangean Kab. Kuantan Singingi,2,0,0,0,0,2
Kec. Logas Tanah Darat Kab. Kuantan Singingi,0,0,0,0,0,0
Kec. Inuman Kab. Kuantan Singingi,0,0,0,0,0,0
Kec. Singingi Hilir Kab. Kuantan Singingi,0,0,0,0,0,0
Kec. Hulu Kuantan Kab. Kuantan Singingi,0,0,0,0,0,0
Kec. Gunung Toar Kab. Kuantan Singingi,0,0,0,0,0,0
Kec. Kuantan Hilir Seberang Kab. Kuantan Singingi,0,0,0,0,0,0
Kec. Sentajo Raya Kab. Kuantan Singingi,2,0,0,0,0,2
Kec. Merbau Kab. Kepulauan Meranti,2,0,0,0,0,2
Kec. Rangsang Kab. Kepulauan Meranti,0,0,0,0,0,0
Kec. Rangsang Barat Kab. Kepulauan Meranti,0,0,0,0,0,0
Kec. Tebing Tinggi Kab. Kepulauan Meranti,8,0,0,0,0,8
Kec. Tebing Tinggi Barat Kab. Kepulauan Meranti,0,0,0,0,0,0
Kec. Tasik Putri Puyu Kab. Kepulauan Meranti,0,0,0,0,0,0
Kec. Pulau Merbau Kab. Kepulauan Meranti,2,0,0,0,0,2
Kec. Tebing Tinggi Timur Kab. Kepulauan Meranti,0,0,0,0,0,0
Kec. Rangsang Pesisir Kab. Kepulauan Meranti,2,0,0,0,0,2
Kec. XIII Koto Kampar Kab. Kampar,2,2,0,0,0,4
Kec. Kampar Kiri Kab. Kampar,2,0,0,0,0,2
Kec. Kampar Kab. Kampar,0,0,0,0,0,0
Kec. Tambang Kab. Kampar,4,0,0,0,0,4
Kec. Bangkinang Kab. Kampar,0,0,0,0,0,0
Kec. Kuok Kab. Kampar,1,1,0,0,0,2
Kec. Siak Hulu Kab. Kampar,8,2,0,0,0,10
Kec. Tapung Kab. Kampar,5,3,0,0,0,8
Kec. Kampar Kiri Hulu Kab. Kampar,2,0,0,0,0,2
Kec. Kampar Kiri Hilir Kab. Kampar,2,0,0,0,0,2
Kec. Tapung Hulu Kab. Kampar,8,0,0,0,0,8
Kec. Tapung Hilir Kab. Kampar,3,1,0,0,0,4
Kec. Salo Kab. Kampar,0,0,0,0,0,0
Kec. Rumbio Jaya Kab. Kampar,0,0,0,0,0,0
Kec. Bangkinang Kota Kab. Kampar,9,1,0,0,0,10
Kec. Perhentian Raja Kab. Kampar,1,1,0,0,0,2
Kec. Kampa Kab. Kampar,4,0,0,0,0,4
Kec. Kampar Utara Kab. Kampar,0,0,0,0,0,0
Kec. Kampar Kiri Tengah Kab. Kampar,3,1,0,0,0,4
Kec. Gunung Sahilan Kab. Kampar,2,0,0,0,0,2
Kec. Koto Kampar Hulu Kab. Kampar,1,1,0,0,0,2
Kec. Mandau Kab. Bengkalis,21,5,0,0,0,26
Kec. Bengkalis Kab. Bengkalis,8,1,0,0,0,9
Kec. Bantan Kab. Bengkalis,1,1,0,0,0,2
Kec. Bukit Batu Kab. Bengkalis,6,0,0,0,0,6
Kec. Rupat Kab. Bengkalis,2,2,0,0,0,4
Kec. Rupat Utara Kab. Bengkalis,2,0,0,0,0,2
Kec. Siak Kecil Kab. Bengkalis,0,0,0,0,0,0
Kec. Pinggir Kab. Bengkalis,10,1,0,0,0,11
Kec. Bathin Solapan Kab. Bengkalis,0,0,0,0,0,0
Kec. Talang Muandau Kab. Bengkalis,0,0,0,0,0,0
Kec. Tampan Kota Pekanbaru,20,2,0,0,0,22
Kec. Bukit Raya Kota Pekanbaru,9,1,0,0,0,10
Kec. Lima Puluh Kota Pekanbaru,9,1,0,0,0,10
Kec. Sail Kota Pekanbaru,5,3,0,0,0,8
Kec. Pekanbaru Kota Kota Pekanbaru,1,1,0,0,0,2
Kec. Sukajadi Kota Pekanbaru,8,2,0,0,0,10
Kec. Senapelan Kota Pekanbaru,6,2,0,0,0,8
Kec. Rumbai Kota Pekanbaru,1,1,0,0,0,2
Kec. Tenayan Raya Kota Pekanbaru,10,2,0,0,0,12
Kec. Marpoyan Damai Kota Pekanbaru,6,2,0,0,0,8
Kec. Rumbai Pesisir Kota Pekanbaru,12,0,0,0,0,12
Kec. Payung Sekaki Kota Pekanbaru,14,6,0,0,0,20
Kec. Bukit Kapur Kota Dumai,2,0,0,0,0,2
Kec. Dumai Barat Kota Dumai,2,0,0,0,0,2
Kec. Dumai Timur Kota Dumai,2,0,0,0,0,2
Kec. Medang Kampai Kota Dumai,0,0,0,0,0,0
Kec. Sungai Sembilan Kota Dumai,0,0,0,0,0,0
Kec. Dumai Kota Kota Dumai,3,1,0,0,0,4
Kec. Dumai Selatan Kota Dumai,6,2,0,0,0,8
Kec. Kubu Kab. Rokan Hilir,2,0,0,0,0,2
Kec. Bangko Kab. Rokan Hilir,30,4,0,0,0,34
Kec. Tanah Putih Kab. Rokan Hilir,9,1,0,0,0,10
Kec. Rimba Melintang Kab. Rokan Hilir,3,1,0,0,0,4
Kec. Bagan Sinembah Kab. Rokan Hilir,14,6,0,0,0,20
Kec. Pasir Limau Kapas Kab. Rokan Hilir,9,2,0,0,0,11
Kec. Sinaboi Kab. Rokan Hilir,2,0,0,0,0,2
Kec. Tanah Pth Tanjung Melawan Kab. Rokan Hilir,2,0,0,0,0,2
Kec. Pujud Kab. Rokan Hilir,2,7,0,0,0,9
Kec. Bangko Pusako Kab. Rokan Hilir,6,2,0,0,0,8
Kec. Simpang Kanan Kab. Rokan Hilir,1,1,0,0,0,2
Kec. Batu Hampar Kab. Rokan Hilir,2,0,0,0,0,2
Kec. Rantau Kopar Kab. Rokan Hilir,2,0,0,0,0,2
Kec. Pekaitan Kab. Rokan Hilir,0,0,0,0,0,0
Kec. Kubu Babussalam Kab. Rokan Hilir,6,0,0,0,0,6
Kec. Minas Kab. Siak,0,2,0,0,0,2
Kec. Siak Kab. Siak,3,1,0,0,0,4
Kec. Sungai Apit Kab. Siak,0,0,0,0,0,0
Kec. Tualang Kab. Siak,4,0,0,0,0,4
Kec. Kerinci Kanan Kab. Siak,0,0,0,0,0,0
Kec. Dayun Kab. Siak,0,0,0,0,0,0
Kec. Bunga Raya Kab. Siak,0,0,0,0,0,0
Kec. Sungai Mandau Kab. Siak,0,2,0,0,0,2
Kec. Kandis Kab. Siak,5,1,0,0,0,6
Kec. Lubuk Dalam Kab. Siak,2,0,0,0,0,2
Kec. Koto Gasib Kab. Siak,2,0,0,0,0,2
Kec. Pusako Kab. Siak,0,0,0,0,0,0
Kec. Sabak Auh Kab. Siak,2,2,0,0,0,4
Kec. Mempura Kab. Siak,0,0,0,0,0,0
Kec. Peranap Kab. Indragiri Hulu,4,2,0,0,0,6
Kec. Pasir Penyu Kab. Indragiri Hulu,5,1,0,0,0,6
Kec. Kelayang Kab. Indragiri Hulu,4,0,0,0,0,4
Kec. Seberida Kab. Indragiri Hulu,0,0,0,0,0,0
Kec. Rengat Kab. Indragiri Hulu,6,2,0,0,0,8
Kec. Rengat Barat Kab. Indragiri Hulu,4,0,0,0,0,4
Kec. Lirik Kab. Indragiri Hulu,2,0,0,0,0,2
Kec. Batang Gansal Kab. Indragiri Hulu,0,0,0,0,0,0
Kec. Batang Cenaku Kab. Indragiri Hulu,3,1,0,0,0,4
Kec. Lubuk Batu Jaya Kab. Indragiri Hulu,0,0,0,0,0,0
Kec. Sei Lala Kab. Indragiri Hulu,2,0,0,0,0,2
Kec. Rakit Kulim Kab. Indragiri Hulu,3,1,0,0,0,4
Kec. Kuala Cenaku Kab. Indragiri Hulu,0,0,0,0,0,0
Kec. Keritang Kab. Indragiri Hilir,4,0,0,0,0,4
Kec. Reteh Kab. Indragiri Hilir,2,0,0,0,0,2
Kec. Enok Kab. Indragiri Hilir,4,0,0,0,0,4
Kec. Tanah Merah Kab. Indragiri Hilir,1,1,0,0,0,2
Kec. Kuala Indragiri Kab. Indragiri Hilir,0,4,0,0,0,4
Kec. Tembilahan Kab. Indragiri Hilir,14,0,0,0,0,14
Kec. Tempuling Kab. Indragiri Hilir,0,0,0,0,0,0
Kec. Batang Tuaka Kab. Indragiri Hilir,0,0,0,0,0,0
Kec. Gaung Anak Serka Kab. Indragiri Hilir,3,1,0,0,0,4
Kec. Gaung Kab. Indragiri Hilir,3,1,0,0,0,4
Kec. Mandah Kab. Indragiri Hilir,1,1,0,0,0,2
Kec. Kateman Kab. Indragiri Hilir,2,0,0,0,0,2
Kec. Kemuning Kab. Indragiri Hilir,1,1,0,0,0,2
Kec. Pelangiran Kab. Indragiri Hilir,0,0,0,0,0,0
Kec. Pulau Burung Kab. Indragiri Hilir,1,1,0,0,0,2
Kec. Teluk Belengkong Kab. Indragiri Hilir,2,2,0,0,0,4
Kec. Tembilahan Hulu Kab. Indragiri Hilir,2,0,0,0,0,2
Kec. Concong Kab. Indragiri Hilir,2,0,0,0,0,2
Kec. Kempas Kab. Indragiri Hilir,0,0,0,0,0,0
Kec. Sungai Batang Kab. Indragiri Hilir,0,0,0,0,0,0
Kec. Rimbo Bujang Kab. Tebo,5,1,0,0,0,6
Kec. Tebo Ilir Kab. Tebo,0,0,0,0,0,0
Kec. Tebo Tengah Kab. Tebo,3,1,0,0,0,4
Kec. Tebo Ulu Kab. Tebo,2,0,0,0,0,2
Kec. Sumay Kab. Tebo,0,0,0,0,0,0
Kec. VII Koto Kab. Tebo,3,1,0,0,0,4
Kec. Rimbo Ilir Kab. Tebo,3,0,0,0,0,3
Kec. Rimbo Ulu Kab. Tebo,5,1,0,0,0,6
Kec. Tengah Ilir Kab. Tebo,0,0,0,0,0,0
Kec. Serai Serumpun Kab. Tebo,0,4,0,0,0,4
Kec. Muara Tabir Kab. Tebo,1,1,0,0,0,2
Kec. Kota Baru Kota Jambi,12,2,0,0,0,14
Kec. Jambi Selatan Kota Jambi,10,4,0,0,0,14
Kec. Jelutung Kota Jambi,14,1,0,0,0,15
Kec. Telanai Pura Kota Jambi,10,2,0,0,0,12
Kec. Danau Teluk Kota Jambi,1,0,0,0,0,1
Kec. Jambi Timur Kota Jambi,9,1,0,0,0,10
Kec. Alam Barajo Kota Jambi,6,2,0,0,0,8
Kec. Danau Sipin Kota Jambi,12,6,0,0,0,18
Kec. Paal Merah Kota Jambi,10,5,0,0,0,15
Kec. Sungai Penuh Kota Sungai Penuh,5,0,0,0,0,5
Kec. Hamparan Rawang Kota Sungai Penuh,0,0,0,0,0,0
Kec. Pondok Tinggi Kota Sungai Penuh,0,0,0,0,0,0
Kec. Koto Baru Kota Sungai Penuh,2,0,0,0,0,2
Kec. Sungai Bungkal Kota Sungai Penuh,0,0,0,0,0,0
Kec. Mersam Kab. Batang Hari,2,0,0,0,0,2
Kec. Muara Tembesi Kab. Batang Hari,0,0,0,0,0,0
Kec. Batin XXIV Kab. Batang Hari,3,1,0,0,0,4
Kec. Muara Bulian Kab. Batang Hari,14,1,0,0,0,15
Kec. Pemayung Kab. Batang Hari,3,1,0,0,0,4
Kec. Maro Sebo Ulu Kab. Batang Hari,2,0,0,0,0,2
Kec. Bajubang Kab. Batang Hari,2,0,0,0,0,2
Kec. Maro Sebo Ilir Kab. Batang Hari,0,0,0,0,0,0
Kec. Tanah Tumbuh Kab. Bungo,0,0,0,0,0,0
Kec. Tanah Sepenggal Kab. Bungo,0,0,0,0,0,0
Kec. Jujuhan Kab. Bungo,0,0,0,0,0,0
Kec. Rantau Pandan Kab. Bungo,3,1,0,0,0,4
Kec. Pelepat Kab. Bungo,0,0,0,0,0,0
Kec. Pelepat Ilir Kab. Bungo,3,1,0,0,0,4
Kec. Limbur Lubuk Mengkuang Kab. Bungo,0,0,0,0,0,0
Kec. Bathin II Babeko Kab. Bungo,2,0,0,0,0,2
Kec. Muko Muko Batin VII Kab. Bungo,0,0,0,0,0,0
Kec. Bathin III Kab. Bungo,2,0,0,0,0,2
Kec. Bathin II Pelayang Kab. Bungo,0,0,0,0,0,0
Kec. Jujuhan Ilir Kab. Bungo,0,0,0,0,0,0
Kec. Rimbo Tengah Kab. Bungo,7,1,0,0,0,8
Kec. Tanah Sepenggal Lintas Kab. Bungo,1,3,0,0,0,4
Kec. Jambi Luar Kota Kab. Muaro Jambi,7,2,0,0,0,9
Kec. Mestong Kab. Muaro Jambi,3,0,0,0,0,3
Kec. Kumpeh Ulu Kab. Muaro Jambi,1,3,0,0,0,4
Kec. Sekernan Kab. Muaro Jambi,0,2,0,0,0,2
Kec. Maro Sebo Kab. Muaro Jambi,2,0,0,0,0,2
Kec. Kumpeh Kab. Muaro Jambi,0,0,0,0,0,0
Kec. Sungai Bahar Kab. Muaro Jambi,4,0,0,0,0,4
Kec. Sungai Gelam Kab. Muaro Jambi,4,1,0,0,0,5
Kec. Bahar Utara Kab. Muaro Jambi,0,0,0,0,0,0
Kec. Bahar Selatan Kab. Muaro Jambi,2,0,0,0,0,2
Kec. Mendahara Kab. Tanjung Jabung Timur,0,0,0,0,0,0
Kec. Dendang Kab. Tanjung Jabung Timur,0,0,0,0,0,0
Kec. Nipah Panjang Kab. Tanjung Jabung Timur,2,0,0,0,0,2
Kec. Rantau Rasau Kab. Tanjung Jabung Timur,2,0,0,0,0,2
Kec. Sadu Kab. Tanjung Jabung Timur,0,0,0,0,0,0
Kec. Geragai Kab. Tanjung Jabung Timur,2,0,0,0,0,2
Kec. Muara Sabak Barat Kab. Tanjung Jabung Timur,0,0,0,0,0,0
Kec. Kuala Jambi Kab. Tanjung Jabung Timur,1,1,0,0,0,2
Kec. Berbak Kab. Tanjung Jabung Timur,0,0,0,0,0,0
Kec. Muara Sabak Timur Kab. Tanjung Jabung Timur,2,2,0,0,0,4
Kec. Jangkat Kab. Merangin,0,0,0,0,0,0
Kec. Bangko Kab. Merangin,2,2,0,0,0,4
Kec. Pamenang Kab. Merangin,1,0,1,0,0,2
Kec. Muara Siau Kab. Merangin,0,0,0,0,0,0
Kec. Sungai Manau Kab. Merangin,1,1,0,0,0,2
Kec. Tabir Kab. Merangin,2,0,0,0,0,2
Kec. Tabir Ulu Kab. Merangin,1,1,0,0,0,2
Kec. Lembah Masurai Kab. Merangin,0,0,0,0,0,0
Kec. Tabir Selatan Kab. Merangin,0,0,0,0,0,0
Kec. Nalo Tantan Kab. Merangin,0,0,0,0,0,0
Kec. Batang Masumai Kab. Merangin,3,1,0,0,0,4
Kec. Pamenang Barat Kab. Merangin,0,2,0,0,0,2
Kec. Renah Pemparap Kab. Merangin,0,0,0,0,0,0
Kec. Jangkat Timur Kab. Merangin,1,1,0,0,0,2
Kec. Tiang Pumpung Kab. Merangin,2,0,0,0,0,2
Kec. Renah Pamenang  Kab. Merangin,2,0,0,0,0,2
Kec. Tabir Lintas Kab. Merangin,0,0,0,0,0,0
Kec. Margo Tabir Kab. Merangin,5,1,0,0,0,6
Kec. Tabir Barat Kab. Merangin,0,0,0,0,0,0
Kec. Batang Asai Kab. Sarolangun,1,1,0,0,0,2
Kec. Limun Kab. Sarolangun,0,0,0,0,0,0
Kec. Sarolangun Kab. Sarolangun,4,0,0,0,0,4
Kec. Pelawan Kab. Sarolangun,5,1,0,0,0,6
Kec. Pauh Kab. Sarolangun,3,1,0,0,0,4
Kec. Mandiangin Kab. Sarolangun,1,1,0,0,0,2
Kec. Air Hitam Kab. Sarolangun,0,0,0,0,0,0
Kec. Bathin VIII Kab. Sarolangun,0,0,0,0,0,0
Kec. Singkut Kab. Sarolangun,3,3,0,0,0,6
Kec. Cermin Nan Gedang Kab. Sarolangun,0,2,0,0,0,2
Kec. Tungkal Ulu Kab. Tanjung Jabung Barat,4,2,0,0,0,6
Kec. Pengabuan Kab. Tanjung Jabung Barat,1,1,0,0,0,2
Kec. Tungkal Ilir Kab. Tanjung Jabung Barat,6,0,0,0,0,6
Kec. Betara Kab. Tanjung Jabung Barat,1,0,0,0,0,1
Kec. Merlung Kab. Tanjung Jabung Barat,1,1,0,0,0,2
Kec. Batang Asam Kab. Tanjung Jabung Barat,1,0,0,0,0,1
Kec. Tebing Tinggi Kab. Tanjung Jabung Barat,2,2,0,0,0,4
Kec. Renah Mendaluh Kab. Tanjung Jabung Barat,2,0,0,0,0,2
Kec. Muara Papalik Kab. Tanjung Jabung Barat,1,2,0,0,0,3
Kec. Senyerang Kab. Tanjung Jabung Barat,3,1,0,0,0,4
Kec. Bram Itam Kab. Tanjung Jabung Barat,0,0,0,0,0,0
Kec. Kuala Betara Kab. Tanjung Jabung Barat,0,0,0,0,0,0
Kec. Gunung Raya Kab. Kerinci,4,0,0,0,0,4
Kec. Batang Merangin Kab. Kerinci,1,1,0,0,0,2
Kec. Keliling Danau Kab. Kerinci,3,1,0,0,0,4
Kec. Danau Kerinci Kab. Kerinci,0,0,0,0,0,0
Kec. Sitinjau Laut Kab. Kerinci,2,0,0,0,0,2
Kec. Gunung Kerinci Kab. Kerinci,0,0,0,0,0,0
Kec. Kayu Aro Kab. Kerinci,1,1,0,0,0,2
Kec. Air Hangat Timur Kab. Kerinci,2,0,0,0,0,2
Kec. Siulak Kab. Kerinci,1,1,0,0,0,2
Kec. Bukit Kerman Kab. Kerinci,1,1,0,0,0,2
Kec. Air Hangat Barat Kab. Kerinci,0,0,0,0,0,0
Kec. Siulak Mukai Kab. Kerinci,0,0,0,0,0,0
Kec. Tanjung Raja Kab. Ogan Ilir,6,2,0,0,0,8
Kec. Muara Kuang Kab. Ogan Ilir,1,1,0,0,0,2
Kec. Tanjung Batu Kab. Ogan Ilir,4,0,0,0,0,4
Kec. Indralaya Kab. Ogan Ilir,3,1,0,0,0,4
Kec. Pemulutan Kab. Ogan Ilir,0,0,0,0,0,0
Kec. Rantau Alai Kab. Ogan Ilir,0,2,0,0,0,2
Kec. Rambang Kuang Kab. Ogan Ilir,2,0,0,0,0,2
Kec. Lubuk Keliat Kab. Ogan Ilir,2,0,0,0,0,2
Kec. Payaraman Kab. Ogan Ilir,2,0,0,0,0,2
Kec. Kandis Kab. Ogan Ilir,2,0,0,0,0,2
Kec. Pemulutan Selatan Kab. Ogan Ilir,2,0,0,0,0,2
Kec. Pemulutan Barat Kab. Ogan Ilir,2,0,0,0,0,2
Kec. Indralaya Selatan Kab. Ogan Ilir,0,2,0,0,0,2
Kec. Indralaya Utara Kab. Ogan Ilir,1,1,0,0,0,2
Kec. Rantau Panjang Kab. Ogan Ilir,1,1,0,0,0,2
Kec. Sungai Pinang Kab. Ogan Ilir,0,0,0,0,0,0
Kec. Lintang Kanan Kab. Empat Lawang,0,0,0,0,0,0
Kec. Muara Pinang Kab. Empat Lawang,1,1,0,0,0,2
Kec. Pendopo Kab. Empat Lawang,0,0,0,0,0,0
Kec. Ulu Musi Kab. Empat Lawang,0,0,0,0,0,0
Kec. Tebing Tinggi Kab. Empat Lawang,10,0,0,0,0,10
Kec. Talang Padang Kab. Empat Lawang,0,0,0,0,0,0
Kec. Pasemah Air Keruh Kab. Empat Lawang,0,0,0,0,0,0
Kec. Sikap Dalam Kab. Empat Lawang,0,0,0,0,0,0
Kec. Saling Kab. Empat Lawang,2,0,0,0,0,2
Kec. Pendopo Barat Kab. Empat Lawang,0,2,0,0,0,2
Kec. Sanga Desa Kab. Musi Banyuasin,1,1,0,0,0,2
Kec. Babat Toman Kab. Musi Banyuasin,2,2,0,0,0,4
Kec. Sungai Keruh Kab. Musi Banyuasin,6,0,0,0,0,6
Kec. Sekayu Kab. Musi Banyuasin,10,6,0,0,0,16
Kec. Sungai Lilin Kab. Musi Banyuasin,9,1,0,0,0,10
Kec. Bayung Lencir Kab. Musi Banyuasin,2,0,0,0,0,2
Kec. Lais Kab. Musi Banyuasin,6,2,0,0,0,8
Kec. Batanghari Leko Kab. Musi Banyuasin,5,1,0,0,0,6
Kec. Keluang Kab. Musi Banyuasin,8,0,0,0,0,8
Kec. Plakat Tinggi Kab. Musi Banyuasin,4,1,0,0,0,5
Kec. Lalan Kab. Musi Banyuasin,1,3,0,0,0,4
Kec. Tungkal Jaya Kab. Musi Banyuasin,3,1,0,0,0,4
Kec. Lawang Wetan Kab. Musi Banyuasin,4,2,0,0,0,6
Kec. Babat Supat Kab. Musi Banyuasin,6,0,0,0,0,6
Kec. Rantau Bayur Kab. Banyuasin,0,0,0,0,0,0
Kec. Talang Kelapa Kab. Banyuasin,8,0,0,0,0,8
Kec. Banyuasin III Kab. Banyuasin,11,1,0,0,0,12
Kec. Betung Kab. Banyuasin,2,0,0,0,0,2
Kec. Makarti Jaya Kab. Banyuasin,2,2,0,0,0,4
Kec. Banyuasin I Kab. Banyuasin,6,2,0,0,0,8
Kec. Banyuasin II Kab. Banyuasin,1,1,0,0,0,2
Kec. Rambutan Kab. Banyuasin,2,0,0,0,0,2
Kec. Muara Telang Kab. Banyuasin,1,1,0,0,0,2
Kec. Muara Padang Kab. Banyuasin,4,0,0,0,0,4
Kec. Tanjung Lago Kab. Banyuasin,2,2,0,0,0,4
Kec. Muara Sugihan Kab. Banyuasin,0,0,0,0,0,0
Kec. Air Salek Kab. Banyuasin,6,1,0,0,0,7
Kec. Tungkal Ilir Kab. Banyuasin,5,2,0,0,0,7
Kec. Suak Tapeh Kab. Banyuasin,0,0,0,0,0,0
Kec. Pulau Rimau Kab. Banyuasin,4,2,0,0,0,6
Kec. Sembawa Kab. Banyuasin,0,2,0,0,0,2
Kec. Sumber Marga Telang Kab. Banyuasin,2,0,0,0,0,2
Kec. Air Kumbang Kab. Banyuasin,2,2,0,0,0,4
Kec. Karang Agung Ilir Kab. Banyuasin,0,0,0,0,0,0
Kec. Pagar Alam Utara Kota Pagar Alam,4,2,0,0,0,6
Kec. Pagar Alam Selatan Kota Pagar Alam,5,3,0,0,0,8
Kec. Dempo Utara Kota Pagar Alam,2,0,0,0,0,2
Kec. Dempo Selatan Kota Pagar Alam,0,0,0,0,0,0
Kec. Dempo Tengah Kota Pagar Alam,3,1,0,0,0,4
Kec. Stl Ulu Terawas Kab. Musi Rawas,6,0,0,0,0,6
Kec. Tugu Mulyo Kab. Musi Rawas,2,2,0,0,0,4
Kec. Muara Beliti Kab. Musi Rawas,4,0,0,0,0,4
Kec. Jayaloka Kab. Musi Rawas,2,0,0,0,0,2
Kec. Muara Kelingi Kab. Musi Rawas,2,0,0,0,0,2
Kec. Muara Lakitan Kab. Musi Rawas,2,2,0,0,0,4
Kec. Megang Sakti Kab. Musi Rawas,4,0,0,0,0,4
Kec. Purwodadi Kab. Musi Rawas,4,0,0,0,0,4
Kec. Selangit Kab. Musi Rawas,2,2,0,0,0,4
Kec. Bulan Tengah Suku Ulu Kab. Musi Rawas,0,0,0,0,0,0
Kec. Tiang Pumpung Kepungut Kab. Musi Rawas,0,0,0,0,0,0
Kec. Sumber Harta Kab. Musi Rawas,1,1,0,0,0,2
Kec. Tuah Negeri Kab. Musi Rawas,4,0,0,0,0,4
Kec. Suka Karya Kab. Musi Rawas,3,1,0,0,0,4
Kec. Martapura Kab. Ogan Komering Ulu Timur,5,3,0,0,0,8
Kec. Buay Madang Kab. Ogan Komering Ulu Timur,6,2,0,0,0,8
Kec. Cempaka Kab. Ogan Komering Ulu Timur,3,1,0,0,0,4
Kec. Madang Suku I Kab. Ogan Komering Ulu Timur,2,0,0,0,0,2
Kec. Madang Suku II Kab. Ogan Komering Ulu Timur,0,0,0,0,0,0
Kec. Belitang II Kab. Ogan Komering Ulu Timur,2,0,0,0,0,2
Kec. Belitang III Kab. Ogan Komering Ulu Timur,1,1,0,0,0,2
Kec. Buay Pemuka Peliung Kab. Ogan Komering Ulu Timur,2,0,0,0,0,2
Kec. Semendawai Suku III Kab. Ogan Komering Ulu Timur,1,1,0,0,0,2
Kec. Buay Madang Timur Kab. Ogan Komering Ulu Timur,4,2,0,0,0,6
Kec. Madang Suku III Kab. Ogan Komering Ulu Timur,0,0,0,0,0,0
Kec. Semendawai Barat Kab. Ogan Komering Ulu Timur,1,2,0,0,0,3
Kec. Semendawai Timur Kab. Ogan Komering Ulu Timur,1,1,0,0,0,2
Kec. Jayapura Kab. Ogan Komering Ulu Timur,0,0,0,0,0,0
Kec. Belitang Jaya Kab. Ogan Komering Ulu Timur,1,0,0,0,0,1
Kec. Belitang Madang Raya Kab. Ogan Komering Ulu Timur,4,0,0,0,0,4
Kec. Belitang Kab. Ogan Komering Ulu Timur,8,4,0,0,0,12
Kec. Kota Agung Kab. Lahat,0,2,0,0,0,2
Kec. Pulau Pinang Kab. Lahat,2,0,0,0,0,2
Kec. Jarai Kab. Lahat,4,0,0,0,0,4
Kec. Kikim Timur Kab. Lahat,0,0,0,0,0,0
Kec. Lahat Kab. Lahat,23,5,0,0,0,28
Kec. Mulak Ulu Kab. Lahat,0,0,0,0,0,0
Kec. Pajar Bulan Kab. Lahat,1,1,0,0,0,2
Kec. Kikim Selatan Kab. Lahat,0,0,0,0,0,0
Kec. Kikim Barat Kab. Lahat,0,0,0,0,0,0
Kec. Kikim Tengah Kab. Lahat,4,0,0,0,0,4
Kec. Tanjung Sakti Pumi Kab. Lahat,1,1,0,0,0,2
Kec. Tanjung Sakti Pumu Kab. Lahat,2,0,0,0,0,2
Kec. Merapi Barat Kab. Lahat,0,0,0,0,0,0
Kec. Pseksu Kab. Lahat,0,0,0,0,0,0
Kec. Gumay Talang Kab. Lahat,2,0,0,0,0,2
Kec. Pagar Gunung Kab. Lahat,1,1,0,0,0,2
Kec. Merapi Timur Kab. Lahat,2,0,0,0,0,2
Kec. Gumay Ulu Kab. Lahat,2,0,0,0,0,2
Kec. Merapi Selatan Kab. Lahat,0,0,0,0,0,0
Kec. Tanjung Tebat Kab. Lahat,0,0,0,0,0,0
Kec. Muara Payang Kab. Lahat,0,0,0,0,0,0
Kec. Lempuing Kab. Ogan Komering Ilir,1,0,0,0,0,1
Kec. Mesuji Kab. Ogan Komering Ilir,4,2,0,0,0,6
Kec. Tulung Selapan Kab. Ogan Komering Ilir,2,0,0,0,0,2
Kec. Pedamaran Kab. Ogan Komering Ilir,3,1,0,0,0,4
Kec. Tanjung Lubuk Kab. Ogan Komering Ilir,2,0,0,0,0,2
Kec. Kota Kayu Agung Kab. Ogan Komering Ilir,11,3,0,0,0,14
Kec. Sirah Pulau Padang Kab. Ogan Komering Ilir,2,0,0,0,0,2
Kec. Pampangan Kab. Ogan Komering Ilir,1,1,0,0,0,2
Kec. Air Sugihan Kab. Ogan Komering Ilir,0,0,0,0,0,0
Kec. Cengal Kab. Ogan Komering Ilir,2,0,0,0,0,2
Kec. Jejawi Kab. Ogan Komering Ilir,0,0,0,0,0,0
Kec. Sungai Menang Kab. Ogan Komering Ilir,4,0,0,0,0,4
Kec. Lempuing Jaya Kab. Ogan Komering Ilir,4,0,0,0,0,4
Kec. Mesuji Makmur Kab. Ogan Komering Ilir,0,0,0,0,0,0
Kec. Mesuji Raya Kab. Ogan Komering Ilir,5,1,0,0,0,6
Kec. Pedamaran Timur Kab. Ogan Komering Ilir,0,0,0,0,0,0
Kec. Teluk Gelam Kab. Ogan Komering Ilir,0,0,0,0,0,0
Kec. Pangkalan Lapam Kab. Ogan Komering Ilir,2,0,0,0,0,2
Kec. Sosoh Buay Rayap Kab. Ogan Komering Ulu,1,1,0,0,0,2
Kec. Pengandonan Kab. Ogan Komering Ulu,1,1,0,0,0,2
Kec. Peninjauan Kab. Ogan Komering Ulu,2,0,0,0,0,2
Kec. Lubuk Batang Kab. Ogan Komering Ulu,2,0,0,0,0,2
Kec. Ulu Ogan Kab. Ogan Komering Ulu,0,0,0,0,0,0
Kec. Semidang Aji Kab. Ogan Komering Ulu,1,1,0,0,0,2
Kec. Lengkiti Kab. Ogan Komering Ulu,3,1,0,0,0,4
Kec. Baturaja Timur Kab. Ogan Komering Ulu,16,4,0,0,0,20
Kec. Baturaja Barat Kab. Ogan Komering Ulu,2,2,0,0,0,4
Kec. Sinar Peninjauan Kab. Ogan Komering Ulu,2,0,0,0,0,2
Kec. Lubuk Raja Kab. Ogan Komering Ulu,1,1,0,0,0,2
Kec. Semende Darat Laut Kab. Muara Enim,0,0,0,0,0,0
Kec. Tanjung Agung Kab. Muara Enim,1,1,0,0,0,2
Kec. Lawang Kidul Kab. Muara Enim,5,1,0,0,0,6
Kec. Muara Enim Kab. Muara Enim,9,3,0,0,0,12
Kec. Gunung Megang Kab. Muara Enim,2,0,0,0,0,2
Kec. Gelumbang Kab. Muara Enim,4,0,0,0,0,4
Kec. Sungai Rotan Kab. Muara Enim,4,2,0,0,0,6
Kec. Lembak Kab. Muara Enim,1,1,0,0,0,2
Kec. Ujan Mas Kab. Muara Enim,2,0,0,0,0,2
Kec. Lubai Kab. Muara Enim,0,0,0,0,0,0
Kec. Rambang Kab. Muara Enim,2,0,0,0,0,2
Kec. Semende Darat Ulu Kab. Muara Enim,2,0,0,0,0,2
Kec. Semende Darat Tengah Kab. Muara Enim,0,0,0,0,0,0
Kec. Rambang Niru Kab. Muara Enim,1,1,0,0,0,2
Kec. Kelekar Kab. Muara Enim,0,0,0,0,0,0
Kec. Muara Belida Kab. Muara Enim,0,0,0,0,0,0
Kec. Lubai Ulu Kab. Muara Enim,0,1,0,0,0,1
Kec. Belimbing Kab. Muara Enim,0,2,0,0,0,2
KEC. PENUKAL UTARA Kab. Penukal Abab Lematang Ilir,2,0,0,0,0,2
KEC. ABAB Kab. Penukal Abab Lematang Ilir,2,0,0,0,0,2
KEC. TANAH ABANG Kab. Penukal Abab Lematang Ilir,6,2,0,0,0,8
KEC. TALANG UBI Kab. Penukal Abab Lematang Ilir,4,4,0,0,0,8
Kec. Penukal Kab. Penukal Abab Lematang Ilir,0,2,0,0,0,2
Kec. Rupit Kab. Musi Rawas Utara,3,1,0,0,0,4
Kec. Rawas Ulu Kab. Musi Rawas Utara,2,0,0,0,0,2
Kec. Nibung Kab. Musi Rawas Utara,2,0,0,0,0,2
Kec. Rawas IIlir Kab. Musi Rawas Utara,0,0,0,0,0,0
Kec. Karang Dapo Kab. Musi Rawas Utara,0,0,0,0,0,0
Kec. Karang Jaya Kab. Musi Rawas Utara,2,0,0,0,0,2
Kec. Ulu Rawas Kab. Musi Rawas Utara,0,0,0,0,0,0
Kec. Ilir Barat II Kota Palembang,3,5,0,0,0,8
Kec. Seberang Ulu I Kota Palembang,28,6,0,0,0,34
Kec. Seberang Ulu II Kota Palembang,16,4,0,0,0,20
Kec. Ilir Barat I Kota Palembang,25,5,0,0,0,30
Kec. Ilir Timur I Kota Palembang,11,3,0,0,0,14
Kec. Ilir Timur II Kota Palembang,34,8,0,0,0,42
Kec. Sako Kota Palembang,2,4,0,0,0,6
Kec. Sukarami Kota Palembang,12,8,0,0,0,20
Kec. Kemuning Kota Palembang,25,1,0,0,0,26
Kec. Plaju Kota Palembang,11,5,0,0,0,16
Kec. Kertapati Kota Palembang,5,6,0,0,0,11
Kec. Gandus Kota Palembang,4,4,0,0,0,8
Kec. Bukit Kecil Kota Palembang,2,2,0,0,0,4
Kec. Kalidoni Kota Palembang,12,4,0,0,0,16
Kec. Alang-Alang Lebar Kota Palembang,6,0,0,0,0,6
Kec. Sematang Borang Kota Palembang,0,0,0,0,0,0
Kec. Prabumulih Timur Kota Prabumulih,6,4,0,0,0,10
Kec. Prabumulih Barat Kota Prabumulih,4,2,0,0,0,6
Kec. Cambai Kota Prabumulih,2,0,0,0,0,2
Kec. Rambang Kapak Tengah Kota Prabumulih,0,2,0,0,0,2
Kec. Prabumulih Utara Kota Prabumulih,6,2,0,0,0,8
Kec. Prabumulih Selatan Kota Prabumulih,1,3,0,0,0,4
Kec. Lubuk Linggau Barat I Kota Lubuk Linggau,4,2,0,0,0,6
Kec. Lubuk Linggau Timur I Kota Lubuk Linggau,10,2,0,0,0,12
Kec. Lubuk Linggau Selatan I Kota Lubuk Linggau,2,0,0,0,0,2
Kec. Lubuk Linggau Utara I Kota Lubuk Linggau,4,0,0,0,0,4
Kec. Lubuk Linggau Barat II Kota Lubuk Linggau,2,2,0,0,0,4
Kec. Lubuk Linggau Timur II Kota Lubuk Linggau,4,0,0,0,0,4
Kec. Lubuk Linggau Selatan II Kota Lubuk Linggau,2,0,0,0,0,2
Kec. Lubuk Linggau Utara II Kota Lubuk Linggau,2,0,0,0,0,2
Kec. Banding Agung Kab. Ogan Komering Ulu Selatan,1,1,0,0,0,2
Kec. Pulau Beringin Kab. Ogan Komering Ulu Selatan,2,0,0,0,0,2
Kec. Muaradua Kisam Kab. Ogan Komering Ulu Selatan,0,0,0,0,0,0
Kec. Muaradua Kab. Ogan Komering Ulu Selatan,2,0,0,0,0,2
Kec. Simpang Kab. Ogan Komering Ulu Selatan,0,0,0,0,0,0
Kec. Buay Sandang Aji Kab. Ogan Komering Ulu Selatan,0,0,0,0,0,0
Kec. Buay Runjung Kab. Ogan Komering Ulu Selatan,2,0,0,0,0,2
Kec. Buay Pemaca Kab. Ogan Komering Ulu Selatan,2,0,0,0,0,2
Kec. Mekakau Ilir Kab. Ogan Komering Ulu Selatan,0,0,0,0,0,0
Kec. Kisam Tinggi Kab. Ogan Komering Ulu Selatan,0,0,0,0,0,0
Kec. Kisam Ilir Kab. Ogan Komering Ulu Selatan,0,0,0,0,0,0
Kec. BPR Ranau Tengah Kab. Ogan Komering Ulu Selatan,2,0,0,0,0,2
Kec. Warkuk Ranau Selatan Kab. Ogan Komering Ulu Selatan,2,0,0,0,0,2
Kec. Runjung Agung Kab. Ogan Komering Ulu Selatan,2,0,0,0,0,2
Kec. Sungai Are Kab. Ogan Komering Ulu Selatan,0,0,0,0,0,0
Kec. Sindang Danau Kab. Ogan Komering Ulu Selatan,3,1,0,0,0,4
Kec. Tiga Dihaji Kab. Ogan Komering Ulu Selatan,0,0,0,0,0,0
Kec. Buay Rawan Kab. Ogan Komering Ulu Selatan,0,0,0,0,0,0
Kec. Mesuji Kab. Mesuji,1,1,0,0,0,2
Kec. Tanjung Raya Kab. Mesuji,0,0,0,0,0,0
Kec. Rawajitu Utara Kab. Mesuji,0,0,0,0,0,0
Kec. Mesuji Timur Kab. Mesuji,0,0,0,0,0,0
Kec. Simpang Pematang Kab. Mesuji,2,2,0,0,0,4
Kec. Way Serdang Kab. Mesuji,2,1,0,0,0,3
Kec. Panca Jaya Kab. Mesuji,1,1,0,0,0,2
Kec. Tulang Bawang Udik Kab. Tulang Bawang Barat,4,0,0,0,0,4
Kec. Tumijajar Kab. Tulang Bawang Barat,5,3,0,0,0,8
Kec. Tulang Bawang Tengah Kab. Tulang Bawang Barat,2,0,0,0,0,2
Kec. Lambu Kibang Kab. Tulang Bawang Barat,0,0,0,0,0,0
Kec. Pagar Dewa Kab. Tulang Bawang Barat,2,0,0,0,0,2
Kec. Way Kenanga Kab. Tulang Bawang Barat,2,0,0,0,0,2
Kec. Gunung Terang Kab. Tulang Bawang Barat,2,0,0,0,0,2
Kec. Gunung Agung Kab. Tulang Bawang Barat,2,0,0,0,0,2
KEC. BANGKUNAT Kab. Pesisir Barat,1,1,0,0,0,2
KEC. PESISIR SELATAN Kab. Pesisir Barat,4,0,0,0,0,4
KEC. NGAMBUR Kab. Pesisir Barat,1,1,0,0,0,2
Kec. Lemong Kab. Pesisir Barat,1,1,0,0,0,2
KEC. NGARAS Kab. Pesisir Barat,0,0,0,0,0,0
KEC. KARYAPENGGAWA Kab. Pesisir Barat,0,2,0,0,0,2
KEC. PESISIR TENGAH Kab. Pesisir Barat,3,1,0,0,0,4
KEC. PESISIR UTARA Kab. Pesisir Barat,1,1,0,0,0,2
KEC. KRUI SELATAN Kab. Pesisir Barat,0,0,0,0,0,0
Kec. Natar Kab. Lampung Selatan,10,4,0,0,0,14
Kec. Jati Agung Kab. Lampung Selatan,9,1,0,0,0,10
Kec. Tanjung Bintang Kab. Lampung Selatan,0,0,0,0,0,0
Kec. Katibung Kab. Lampung Selatan,0,2,0,0,0,2
Kec. Sidomulyo Kab. Lampung Selatan,9,1,0,0,0,10
Kec. Palas Kab. Lampung Selatan,2,0,0,0,0,2
Kec. Penengahan Kab. Lampung Selatan,7,4,0,0,0,11
Kec. Merbau Mataram Kab. Lampung Selatan,2,0,0,0,0,2
Kec. Candipuro Kab. Lampung Selatan,4,0,0,0,0,4
Kec. Rajabasa Kab. Lampung Selatan,1,1,0,0,0,2
Kec. Sragi Kab. Lampung Selatan,2,2,0,0,0,4
Kec. Ketapang Kab. Lampung Selatan,1,0,0,0,0,1
Kec. Bakauheni Kab. Lampung Selatan,0,0,0,0,0,0
Kec. Tanjung Sari Kab. Lampung Selatan,3,1,0,0,0,4
Kec. Way Sulan Kab. Lampung Selatan,0,2,0,0,0,2
Kec. Kalianda Kab. Lampung Selatan,13,1,0,0,0,14
Kec. Padang Ratu Kab. Lampung Tengah,4,0,0,0,0,4
Kec. Kalirejo Kab. Lampung Tengah,2,1,0,0,0,3
Kec. Bangunrejo Kab. Lampung Tengah,4,0,0,0,0,4
Kec. Gunung Sugih Kab. Lampung Tengah,1,1,0,0,0,2
Kec. Trimurjo Kab. Lampung Tengah,3,1,0,0,0,4
Kec. Punggur Kab. Lampung Tengah,3,1,0,0,0,4
Kec. Seputih Raman Kab. Lampung Tengah,0,2,0,0,0,2
Kec. Terbanggi Besar Kab. Lampung Tengah,4,4,0,0,0,8
Kec. Terusan Nunyai Kab. Lampung Tengah,2,0,0,0,0,2
Kec. Seputih Mataram Kab. Lampung Tengah,4,2,0,0,0,6
Kec. Seputih Banyak Kab. Lampung Tengah,6,2,0,0,0,8
Kec. Rumbia Kab. Lampung Tengah,1,1,0,0,0,2
Kec. Seputih Surabaya Kab. Lampung Tengah,0,2,0,0,0,2
Kec. Bumi Ratu Nuban Kab. Lampung Tengah,1,1,0,0,0,2
Kec. Way Pengubuan Kab. Lampung Tengah,1,1,0,0,0,2
Kec. Seputih Agung Kab. Lampung Tengah,3,1,0,0,0,4
Kec. Bandar Mataram Kab. Lampung Tengah,2,0,0,0,0,2
Kec. Sendang Agung Kab. Lampung Tengah,3,1,0,0,0,4
Kec. Anak Tuha Kab. Lampung Tengah,4,2,0,0,0,6
Kec. Pubian Kab. Lampung Tengah,0,0,0,0,0,0
Kec. Bandar Surabaya Kab. Lampung Tengah,2,0,0,0,0,2
Kec. Bumi Nabung Kab. Lampung Tengah,2,2,0,0,0,4
Kec. Way Seputih Kab. Lampung Tengah,4,0,0,0,0,4
Kec. Kota Gajah Kab. Lampung Tengah,3,2,0,0,0,5
Kec. Selagai Lingga Kab. Lampung Tengah,2,0,0,0,0,2
Kec. Bekri Kab. Lampung Tengah,0,0,0,0,0,0
Kec. Anak Ratu Aji Kab. Lampung Tengah,2,0,0,0,0,2
Kec. Putra Rumbia Kab. Lampung Tengah,0,0,0,0,0,0
Kec. Metro Kibang Kab. Lampung Timur,0,0,0,0,0,0
Kec. Batanghari Kab. Lampung Timur,2,0,0,0,0,2
Kec. Sekampung Kab. Lampung Timur,6,2,0,0,0,8
Kec. Margatiga Kab. Lampung Timur,1,1,0,0,0,2
Kec. Sekampung Udik Kab. Lampung Timur,0,6,0,0,0,6
Kec. Jabung Kab. Lampung Timur,0,0,0,0,0,0
Kec. Labuhan Maringgai Kab. Lampung Timur,1,1,0,0,0,2
Kec. Way Jepara Kab. Lampung Timur,5,5,0,0,0,10
Kec. Sukadana Kab. Lampung Timur,1,1,0,0,0,2
Kec. Pekalongan Kab. Lampung Timur,4,2,0,0,0,6
Kec. Raman Utara Kab. Lampung Timur,0,0,0,0,0,0
Kec. Purbolinggo Kab. Lampung Timur,4,1,0,0,0,5
Kec. Braja Selebah Kab. Lampung Timur,3,1,0,0,0,4
Kec. Bandar Sribhawono Kab. Lampung Timur,2,2,0,0,0,4
Kec. Melinting Kab. Lampung Timur,1,1,0,0,0,2
Kec. Gunung Pelindung Kab. Lampung Timur,0,4,0,0,0,4
Kec. Waway Karya Kab. Lampung Timur,2,0,0,0,0,2
Kec. Pasir Sakti Kab. Lampung Timur,4,0,0,0,0,4
Kec. Labuhan Ratu Kab. Lampung Timur,2,2,0,0,0,4
Kec. Way Bungur Kab. Lampung Timur,0,0,0,0,0,0
Kec. Banjit Kab. Way Kanan,5,1,0,0,0,6
Kec. Baradatu Kab. Way Kanan,3,1,0,0,0,4
Kec. Kasui Kab. Way Kanan,1,1,0,0,0,2
Kec. Blambangan Umpu Kab. Way Kanan,7,1,0,0,0,8
Kec. Pakuan Ratu Kab. Way Kanan,6,4,0,0,0,10
Kec. Gunung Labuhan Kab. Way Kanan,2,2,0,0,0,4
Kec. Rebang Tangkas Kab. Way Kanan,0,0,0,0,0,0
Kec. Way Tuba Kab. Way Kanan,1,1,0,0,0,2
Kec. Negeri Agung Kab. Way Kanan,1,1,0,0,0,2
Kec. Negara Batin Kab. Way Kanan,1,1,0,0,0,2
Kec. Negeri Besar Kab. Way Kanan,2,2,0,0,0,4
Kec. Buay Bahuga Kab. Way Kanan,1,1,0,0,0,2
Kec. Bumi Agung Kab. Way Kanan,0,0,0,0,0,0
Kec. Banjar Agung Kab. Tulang Bawang,4,2,0,0,0,6
Kec. Gedung Aji Kab. Tulang Bawang,0,0,0,0,0,0
Kec. Menggala Kab. Tulang Bawang,1,3,0,0,0,4
Kec. Penawartama Kab. Tulang Bawang,0,2,0,0,0,2
Kec. Rawajitu Selatan Kab. Tulang Bawang,0,0,0,0,0,0
Kec. Gedung Meneng Kab. Tulang Bawang,2,0,0,0,0,2
Kec. Banjar Margo Kab. Tulang Bawang,2,2,0,0,0,4
Kec. Penawar Aji Kab. Tulang Bawang,1,0,0,0,0,1
Kec. Rawa Pitu Kab. Tulang Bawang,0,0,0,0,0,0
Kec. Rawajitu Timur Kab. Tulang Bawang,0,0,0,0,0,0
Kec. Meraksa Aji Kab. Tulang Bawang,0,0,0,0,0,0
Kec. Gedung AJI Baru Kab. Tulang Bawang,0,2,0,0,0,2
Kec. Dente Teladas Kab. Tulang Bawang,2,0,0,0,0,2
Kec. Banjar Baru Kab. Tulang Bawang,2,0,0,0,0,2
Kec. Wonosobo Kab. Tanggamus,0,2,0,0,0,2
Kec. Kota Agung Kab. Tanggamus,4,2,0,0,0,6
Kec. Pulau Panggung Kab. Tanggamus,2,0,0,0,0,2
Kec. Talang Padang Kab. Tanggamus,1,3,0,0,0,4
Kec. Pugung Kab. Tanggamus,0,0,0,0,0,0
Kec. Cukuh Balak Kab. Tanggamus,0,0,0,0,0,0
Kec. Pematang Sawa Kab. Tanggamus,2,0,0,0,0,2
Kec. Sumberejo Kab. Tanggamus,2,0,0,0,0,2
Kec. Semaka Kab. Tanggamus,1,1,0,0,0,2
Kec. Ulu Belu Kab. Tanggamus,3,1,0,0,0,4
Kec. Kelumbayan Kab. Tanggamus,0,0,0,0,0,0
Kec. Kota Agung Barat Kab. Tanggamus,0,0,0,0,0,0
Kec. Gisting Kab. Tanggamus,1,1,0,0,0,2
Kec. Gunung Alip Kab. Tanggamus,1,1,0,0,0,2
Kec. Limau Kab. Tanggamus,0,0,0,0,0,0
Kec. Air Naningan Kab. Tanggamus,0,0,0,0,0,0
Kec. Bulok Kab. Tanggamus,1,1,0,0,0,2
Kec. Kelumbayan Barat Kab. Tanggamus,0,0,0,0,0,0
Kec. Bukit Kemuning Kab. Lampung Utara,1,1,0,0,0,2
Kec. Tanjung Raja Kab. Lampung Utara,3,1,0,0,0,4
Kec. Abung Barat Kab. Lampung Utara,1,1,0,0,0,2
Kec. Kotabumi Kab. Lampung Utara,0,2,0,0,0,2
Kec. Abung Selatan Kab. Lampung Utara,1,1,0,0,0,2
Kec. Abung Timur Kab. Lampung Utara,2,0,0,0,0,2
Kec. Sungkai Selatan Kab. Lampung Utara,1,1,0,0,0,2
Kec. Sungkai Utara Kab. Lampung Utara,0,2,0,0,0,2
Kec. Abung Tinggi Kab. Lampung Utara,1,1,0,0,0,2
Kec. Abung Tengah Kab. Lampung Utara,2,0,0,0,0,2
Kec. Kotabumi Utara Kab. Lampung Utara,4,0,0,0,0,4
Kec. Kotabumi Selatan Kab. Lampung Utara,7,7,0,0,0,14
Kec. Abung Semuli Kab. Lampung Utara,2,0,0,0,0,2
Kec. Abung Surakarta Kab. Lampung Utara,0,0,0,0,0,0
Kec. Muara Sungkai Kab. Lampung Utara,0,0,0,0,0,0
Kec. Bunga Mayang Kab. Lampung Utara,0,0,0,0,0,0
Kec. Hulu Sungkai Kab. Lampung Utara,0,0,0,0,0,0
Kec. Sungkai Tengah Kab. Lampung Utara,2,0,0,0,0,2
Kec. Abung Pekurun Kab. Lampung Utara,2,0,0,0,0,2
Kec. Sungkai Jaya Kab. Lampung Utara,0,0,0,0,0,0
Kec. Sungkai Barat Kab. Lampung Utara,0,0,0,0,0,0
Kec. Abung Kunang Kab. Lampung Utara,2,0,0,0,0,2
Kec. Blambangan Pagar Kab. Lampung Utara,3,1,0,0,0,4
Kec. Balik Bukit Kab. Lampung Barat,4,2,0,0,0,6
Kec. Belalau Kab. Lampung Barat,1,1,0,0,0,2
Kec. Sumber Jaya Kab. Lampung Barat,1,1,0,0,0,2
Kec. Sekincau Kab. Lampung Barat,0,0,0,0,0,0
Kec. Batu Brak Kab. Lampung Barat,0,0,0,0,0,0
Kec. Waytenong Kab. Lampung Barat,2,0,0,0,0,2
Kec. Sukau Kab. Lampung Barat,2,2,0,0,0,4
Kec. Suoh Kab. Lampung Barat,0,0,0,0,0,0
Kec. Lumbok Seminung Kab. Lampung Barat,0,0,0,0,0,0
Kec. Kebun Tebu Kab. Lampung Barat,2,0,0,0,0,2
Kec. Air Hitam Kab. Lampung Barat,0,0,0,0,0,0
Kec. Batu Ketulis Kab. Lampung Barat,0,0,0,0,0,0
Kec. Bandar Negeri Suoh Kab. Lampung Barat,0,0,0,0,0,0
Kec. Pagar Dewa Kab. Lampung Barat,2,0,0,0,0,2
Kec. Teluk Betung Barat Kota Bandar Lampung,3,1,0,0,0,4
Kec. Teluk Betung Selatan Kota Bandar Lampung,1,5,0,0,0,6
Kec. Panjang Kota Bandar Lampung,0,0,0,0,0,0
Kec. Tanjung Karang Timur Kota Bandar Lampung,2,0,0,0,0,2
Kec. Teluk Betung Utara Kota Bandar Lampung,4,2,0,0,0,6
Kec. Tanjung Karang Pusat Kota Bandar Lampung,15,1,0,0,0,16
Kec. Tanjung Karang Barat Kota Bandar Lampung,8,0,0,0,0,8
Kec. Kedaton Kota Bandar Lampung,4,0,0,0,0,4
Kec. Sukarame Kota Bandar Lampung,2,2,0,0,0,4
Kec. Kemiling Kota Bandar Lampung,8,4,0,0,0,12
Kec. Rajabasa Kota Bandar Lampung,10,3,0,0,0,13
Kec. Tanjung Senang Kota Bandar Lampung,7,1,0,0,0,8
Kec. Labuhan Ratu Kota Bandar Lampung,4,4,0,0,0,8
Kec. Kedamaian Kota Bandar Lampung,4,0,0,0,0,4
Kec. Enggal Kota Bandar Lampung,13,3,0,0,0,16
Kec. Langkapura Kota Bandar Lampung,2,0,0,0,0,2
Kec. Bumi Waras Kota Bandar Lampung,3,1,0,0,0,4
Kec. Teluk Betung Timur Kota Bandar Lampung,2,2,0,0,0,4
Kec. Metro Pusat Kota Metro,6,0,0,0,0,6
Kec. Metro Utara Kota Metro,4,0,0,0,0,4
Kec. Metro Barat Kota Metro,4,5,0,0,0,9
Kec. Metro Timur Kota Metro,5,3,0,0,0,8
Kec. Metro Selatan Kota Metro,10,0,0,0,0,10
Kec. Padang Cermin Kab. Pesawaran,4,2,0,0,0,6
Kec. Punduh Pedada Kab. Pesawaran,0,0,0,0,0,0
Kec. Kedondong Kab. Pesawaran,0,0,0,0,0,0
Kec. Way Lima Kab. Pesawaran,2,0,0,0,0,2
Kec. Gedung Tataan Kab. Pesawaran,4,2,0,0,0,6
Kec. Negeri Katon Kab. Pesawaran,2,0,0,0,0,2
Kec. Tegineneng Kab. Pesawaran,2,4,0,0,0,6
Kec. Marga Punduh Kab. Pesawaran,1,1,0,0,0,2
Kec. Way Khilau Kab. Pesawaran,0,0,0,0,0,0
Kec. Pagelaran Kab. Pringsewu,4,4,0,0,0,8
Kec. Sukoharjo Kab. Pringsewu,1,1,0,0,0,2
Kec. Adiluwih Kab. Pringsewu,0,0,0,0,0,0
Kec. Banyumas Kab. Pringsewu,2,0,0,0,0,2
Kec. Pringsewu Kab. Pringsewu,8,2,0,0,0,10
Kec. Ambarawa Kab. Pringsewu,0,0,0,0,0,0
Kec. Gadingrejo Kab. Pringsewu,6,4,0,0,0,10
Kec. Pardasuka Kab. Pringsewu,0,0,0,0,0,0
Kec. Sungai Raya Kab. Bengkayang,2,0,0,0,0,2
Kec. Capkala Kab. Bengkayang,0,0,0,0,0,0
Kec. Samalantan Kab. Bengkayang,3,1,0,0,0,4
Kec. Bengkayang Kab. Bengkayang,6,4,0,0,0,10
Kec. Ledo Kab. Bengkayang,2,0,0,0,0,2
Kec. Sanggau Ledo Kab. Bengkayang,0,4,0,0,0,4
Kec. Seluas Kab. Bengkayang,2,0,0,0,0,2
Kec. Jagoi Babang Kab. Bengkayang,0,0,0,0,0,0
Kec. Teriak Kab. Bengkayang,0,0,0,0,0,0
Kec. Monterado Kab. Bengkayang,2,0,0,0,0,2
Kec. Suti Semarang Kab. Bengkayang,0,0,0,0,0,0
Kec. Siding Kab. Bengkayang,0,0,0,0,0,0
Kec. Lumar Kab. Bengkayang,0,0,0,0,0,0
Kec. Sungai Betung Kab. Bengkayang,1,1,0,0,0,2
Kec. Sungai Raya Kepulauan Kab. Bengkayang,1,1,0,0,0,2
Kec. Lembah Bawang Kab. Bengkayang,2,0,0,0,0,2
Kec. Tujuh Belas Kab. Bengkayang,2,0,0,0,0,2
Kec. Sebangki Kab. Landak,0,0,0,0,0,0
Kec. Ngabang Kab. Landak,12,6,0,0,0,18
Kec. Sengah Temila Kab. Landak,7,5,0,0,0,12
Kec. Mandor Kab. Landak,5,2,0,0,0,7
Kec. Menjalin Kab. Landak,0,0,0,0,0,0
Kec. Mempawah Hulu Kab. Landak,4,4,0,0,0,8
Kec. Menyuke Kab. Landak,2,0,0,0,0,2
Kec. Meranti Kab. Landak,0,0,0,0,0,0
Kec. Kuala Behe Kab. Landak,3,1,0,0,0,4
Kec. Air Besar Kab. Landak,3,1,0,0,0,4
Kec. Jelimpo Kab. Landak,1,1,0,0,0,2
Kec. Sompak Kab. Landak,5,1,0,0,0,6
Kec. Banyuke Hulu Kab. Landak,2,0,0,0,0,2
Kec. Nanga Mahap Kab. Sekadau,2,0,0,0,0,2
Kec. Nanga Taman Kab. Sekadau,0,0,0,0,0,0
Kec. Sekadau Hulu Kab. Sekadau,1,1,0,0,0,2
Kec. Sekadau Hilir Kab. Sekadau,8,2,0,0,0,10
Kec. Belitang Kab. Sekadau,2,0,0,0,0,2
Kec. Belitang Hilir Kab. Sekadau,4,0,0,0,0,4
Kec. Belitang Hulu Kab. Sekadau,1,1,0,0,0,2
Kec. Siantan Kab. Mempawah,2,0,0,0,0,2
Kec. Sungai Pinyuh Kab. Mempawah,3,3,0,0,0,6
Kec. Mempawah Hilir Kab. Mempawah,3,1,0,0,0,4
Kec. Sungai Kunyit Kab. Mempawah,1,1,0,0,0,2
Kec. Toho Kab. Mempawah,3,0,0,0,0,3
Kec. Segedong Kab. Mempawah,2,0,0,0,0,2
Kec. Anjongan Kab. Mempawah,2,0,0,0,0,2
Kec. Sadaniang Kab. Mempawah,1,1,0,0,0,2
Kec. Mempawah Timur Kab. Mempawah,0,0,0,0,0,0
Kec. Toba Kab. Sanggau,0,0,0,0,0,0
Kec. Jangkang Kab. Sanggau,1,1,0,0,0,2
Kec. Bonti Kab. Sanggau,2,0,0,0,0,2
Kec. Parindu Kab. Sanggau,1,1,0,0,0,2
Kec. Tayan Hilir Kab. Sanggau,4,0,0,0,0,4
Kec. Balai Kab. Sanggau,4,0,0,0,0,4
Kec. Tayan Hulu Kab. Sanggau,6,0,0,0,0,6
Kec. Kembayan Kab. Sanggau,4,1,0,0,0,5
Kec. Beduwai Kab. Sanggau,0,0,0,0,0,0
Kec. Noyan Kab. Sanggau,0,0,0,0,0,0
Kec. Sekayam Kab. Sanggau,4,0,0,0,0,4
Kec. Meliau Kab. Sanggau,4,0,0,0,0,4
Kec. Kapuas Kab. Sanggau,6,2,0,0,0,8
Kec. Serawai Kab. Sintang,1,1,0,0,0,2
Kec. Ambalau Kab. Sintang,0,0,0,0,0,0
Kec. Kayan Hulu Kab. Sintang,0,0,0,0,0,0
Kec. Sepauk Kab. Sintang,2,2,0,0,0,4
Kec. Tempunak Kab. Sintang,2,0,0,0,0,2
Kec. Sungai Tebelian Kab. Sintang,4,0,0,0,0,4
Kec. Sintang Kab. Sintang,22,4,0,0,0,26
Kec. Dedai Kab. Sintang,0,0,0,0,0,0
Kec. Kayan Hilir Kab. Sintang,2,0,0,0,0,2
Kec. Kelam Permai Kab. Sintang,5,1,0,0,0,6
Kec. Binjai Hulu Kab. Sintang,0,0,0,0,0,0
Kec. Ketungau Hilir Kab. Sintang,0,0,0,0,0,0
Kec. Ketungau Tengah Kab. Sintang,1,1,0,0,0,2
Kec. Ketungau Hulu Kab. Sintang,1,1,0,0,0,2
Kec. Singkawang Selatan Kota Singkawang,7,1,0,0,0,8
Kec. Singkawang Timur Kota Singkawang,5,1,0,0,0,6
Kec. Singkawang Utara Kota Singkawang,3,1,0,0,0,4
Kec. Singkawang Barat Kota Singkawang,5,3,0,0,0,8
Kec. Singkawang Tengah Kota Singkawang,4,4,0,0,0,8
Kec. Silat Hilir Kab. Kapuas Hulu,0,0,0,0,0,0
Kec. Silat Hulu Kab. Kapuas Hulu,0,2,0,0,0,2
Kec. Hulu Gurung Kab. Kapuas Hulu,1,1,0,0,0,2
Kec. Bunut Hulu Kab. Kapuas Hulu,3,1,0,0,0,4
Kec. Mentebah Kab. Kapuas Hulu,2,2,0,0,0,4
Kec. Kalis Kab. Kapuas Hulu,0,0,0,0,0,0
Kec. Embaloh Hilir Kab. Kapuas Hulu,0,0,0,0,0,0
Kec. Bunut Hilir Kab. Kapuas Hulu,4,0,0,0,0,4
Kec. Boyan Tanjung Kab. Kapuas Hulu,2,0,0,0,0,2
Kec. Selimbau Kab. Kapuas Hulu,0,0,0,0,0,0
Kec. Suhaid Kab. Kapuas Hulu,2,0,0,0,0,2
Kec. Seberuang Kab. Kapuas Hulu,0,0,0,0,0,0
Kec. Semitau Kab. Kapuas Hulu,0,2,0,0,0,2
Kec. Empanang Kab. Kapuas Hulu,0,0,0,0,0,0
Kec. Badau Kab. Kapuas Hulu,2,2,0,0,0,4
Kec. Batang Lupar Kab. Kapuas Hulu,0,0,0,0,0,0
Kec. Embaloh Hulu Kab. Kapuas Hulu,0,0,0,0,0,0
Kec. Putussibau Utara Kab. Kapuas Hulu,3,1,0,0,0,4
Kec. Bika Kab. Kapuas Hulu,0,0,0,0,0,0
Kec. Jongkong Kab. Kapuas Hulu,2,0,0,0,0,2
Kec. Putussibau Selatan Kab. Kapuas Hulu,2,0,0,0,0,2
Kec. Pengkadan Kab. Kapuas Hulu,0,0,0,0,0,0
Kec. Selakau Kab. Sambas,3,1,0,0,0,4
Kec. Pemangkat Kab. Sambas,3,3,0,0,0,6
Kec. Tebas Kab. Sambas,8,2,0,0,0,10
Kec. Sambas Kab. Sambas,18,2,0,0,0,20
Kec. Jawai Kab. Sambas,0,2,0,0,0,2
Kec. Teluk Keramat Kab. Sambas,14,0,0,0,0,14
Kec. Sejangkung Kab. Sambas,0,0,0,0,0,0
Kec. Sajingan Besar Kab. Sambas,0,2,0,0,0,2
Kec. Paloh Kab. Sambas,5,1,0,0,0,6
Kec. Subah Kab. Sambas,3,0,0,0,0,3
Kec. Galing Kab. Sambas,0,0,0,0,0,0
Kec. Semparuk Kab. Sambas,0,0,0,0,0,0
Kec. Tekarang Kab. Sambas,2,0,0,0,0,2
Kec. Sajad Kab. Sambas,2,0,0,0,0,2
Kec. Sebawi Kab. Sambas,6,0,0,0,0,6
Kec. Jawai Selatan Kab. Sambas,0,0,0,0,0,0
Kec. Salatiga Kab. Sambas,0,0,0,0,0,0
Kec. Sokan Kab. Melawi,0,0,0,0,0,0
Kec. Tanah Pinoh Kab. Melawi,2,0,0,0,0,2
Kec. Sayan Kab. Melawi,0,0,0,0,0,0
Kec. Ella Hilir Kab. Melawi,0,0,0,0,0,0
Kec. Menukung Kab. Melawi,0,0,0,0,0,0
Kec. Nanga Pinoh Kab. Melawi,2,4,0,0,0,6
Kec. Belimbing Kab. Melawi,1,1,0,0,0,2
Kec. Tanah Pinoh Barat Kab. Melawi,4,0,0,0,0,4
Kec. Belimbing Hulu Kab. Melawi,0,0,0,0,0,0
Kec. Pinoh Selatan Kab. Melawi,0,0,0,0,0,0
Kec. Pinoh Utara Kab. Melawi,3,1,0,0,0,4
Kec. Pulau Maya Kab. Kayong Utara,2,0,0,0,0,2
Kec. Simpang Hilir Kab. Kayong Utara,11,3,0,0,0,14
Kec. Sukadana Kab. Kayong Utara,4,0,0,0,0,4
Kec. Teluk Batang Kab. Kayong Utara,1,1,0,0,0,2
Kec. Seponti Kab. Kayong Utara,2,2,0,0,0,4
Kec. Kuala Mandor B Kab. Kuburaya,0,0,0,0,0,0
Kec. Sungai Ambawang Kab. Kuburaya,6,2,0,0,0,8
Kec. Sungai Kakap Kab. Kuburaya,12,2,0,0,0,14
Kec. Telok Pakedai Kab. Kuburaya,1,1,0,0,0,2
Kec. Terentang Kab. Kuburaya,1,1,0,0,0,2
Kec. Sungai Raya Kab. Kuburaya,17,5,0,0,0,22
Kec. Batu Ampar Kab. Kuburaya,1,1,0,0,0,2
Kec. Kubu Kab. Kuburaya,3,1,0,0,0,4
Kec. Rasau Jaya Kab. Kuburaya,6,0,0,0,0,6
Kec. Pontianak Selatan Kota Pontianak,21,4,0,0,0,25
Kec. Pontianak Timur Kota Pontianak,5,5,0,0,0,10
Kec. Pontianak Barat Kota Pontianak,9,3,0,0,0,12
Kec. Pontianak Utara Kota Pontianak,46,6,0,0,0,52
Kec. Pontianak Kota Kota Pontianak,17,5,0,0,0,22
Kec. Pontianak Tenggara Kota Pontianak,16,2,0,0,0,18
Kec. Kendawangan Kab. Ketapang,0,0,0,0,0,0
Kec. Manis Mata Kab. Ketapang,2,0,0,0,0,2
Kec. Marau Kab. Ketapang,1,1,0,0,0,2
Kec. Jelai Hulu Kab. Ketapang,2,0,0,0,0,2
Kec. Tumbang Titi Kab. Ketapang,2,0,0,0,0,2
Kec. Matan Hilir Selatan Kab. Ketapang,2,0,0,0,0,2
Kec. Matan Hilir Utara Kab. Ketapang,2,2,0,0,0,4
Kec. Nanga Tayap Kab. Ketapang,3,0,0,0,0,3
Kec. Sandai Kab. Ketapang,2,0,0,0,0,2
Kec. Sungai Laur Kab. Ketapang,1,1,0,0,0,2
Kec. Simpang Hulu Kab. Ketapang,1,1,0,0,0,2
Kec. Muara Pawan Kab. Ketapang,0,1,0,0,0,1
Kec. Delta Pawan Kab. Ketapang,13,4,0,0,0,17
Kec. Simpang Dua Kab. Ketapang,2,0,0,0,0,2
Kec. Benua Kayong Kab. Ketapang,4,0,0,0,0,4
Kec. Hulu Sungai Kab. Ketapang,0,0,0,0,0,0
Kec. Air Upas Kab. Ketapang,4,0,0,0,0,4
Kec. Singkup Kab. Ketapang,0,0,0,0,0,0
Kec. Sungai Melayu Rayek Kab. Ketapang,1,1,0,0,0,2
Kec. Dusun Timur Kab. Barito Timur,1,1,0,0,0,2
Kec. Benua Lima Kab. Barito Timur,2,0,0,0,0,2
Kec. Patangkep Tutui Kab. Barito Timur,0,0,0,0,0,0
Kec. Awang Kab. Barito Timur,1,1,0,0,0,2
Kec. Dusun Tengah Kab. Barito Timur,0,0,0,0,0,0
Kec. Pematang Karau Kab. Barito Timur,2,0,0,0,0,2
Kec. Paju Epat Kab. Barito Timur,1,1,0,0,0,2
Kec. Raren Batuah Kab. Barito Timur,0,0,0,0,0,0
Kec. Paku Kab. Barito Timur,0,1,0,0,0,1
Kec. Karusen Janang Kab. Barito Timur,0,0,0,0,0,0
Kec. Pahandut Kota Palangka Raya,18,4,0,0,0,22
Kec. Bukit Batu Kota Palangka Raya,8,0,0,0,0,8
Kec. Sabangau Kota Palangka Raya,2,0,0,0,0,2
Kec. Jekan Raya Kota Palangka Raya,15,1,0,0,0,16
Kec. Rakumpit Kota Palangka Raya,0,0,0,0,0,0
Kec. Kapuas Timur Kab. Kapuas,4,0,0,0,0,4
Kec. Selat Kab. Kapuas,8,4,0,0,0,12
Kec. Basarang Kab. Kapuas,1,1,0,0,0,2
Kec. Kapuas Hilir Kab. Kapuas,1,1,0,0,0,2
Kec. Pulau Petak Kab. Kapuas,2,0,0,0,0,2
Kec. Kapuas Murung Kab. Kapuas,3,1,0,0,0,4
Kec. Kapuas Barat Kab. Kapuas,0,0,0,0,0,0
Kec. Mantangai Kab. Kapuas,2,0,0,0,0,2
Kec. Timpah Kab. Kapuas,0,0,0,0,0,0
Kec. Kapuas Tengah Kab. Kapuas,2,0,0,0,0,2
Kec. Kapuas Hulu Kab. Kapuas,0,0,0,0,0,0
Kec. Dadahup Kab. Kapuas,1,1,0,0,0,2
Kec. Tamban Catur Kab. Kapuas,1,1,0,0,0,2
Kec. Pasak Talawang Kab. Kapuas,0,0,0,0,0,0
Kec. Dusun Hilir Kab. Barito Selatan,1,1,0,0,0,2
Kec. Jenamas Kab. Barito Selatan,1,1,0,0,0,2
Kec. Karau Kuala Kab. Barito Selatan,2,0,0,0,0,2
Kec. Dusun Selatan Kab. Barito Selatan,6,2,0,0,0,8
Kec. Dusun Utara Kab. Barito Selatan,0,2,0,0,0,2
Kec. Gunung Bintang Awai Kab. Barito Selatan,2,0,0,0,0,2
Kec. Katingan Kuala Kab. Katingan,0,0,0,0,0,0
Kec. Kamipang Kab. Katingan,0,0,0,0,0,0
Kec. Tasik Payawan Kab. Katingan,0,0,0,0,0,0
Kec. Katingan Hilir Kab. Katingan,3,1,0,0,0,4
Kec. Tewang Sangalang Garing Kab. Katingan,2,0,0,0,0,2
Kec. Pulau Malan Kab. Katingan,3,1,0,0,0,4
Kec. Katingan Tengah Kab. Katingan,1,1,0,0,0,2
Kec. Katingan Hulu Kab. Katingan,0,0,0,0,0,0
Kec. Marikit Kab. Katingan,0,0,0,0,0,0
Kec. Sanaman Mantikei Kab. Katingan,1,1,0,0,0,2
Kec. Petak Malai Kab. Katingan,0,0,0,0,0,0
Kec. Bukit Raya Kab. Katingan,0,0,0,0,0,0
Kec. Seruyan Hilir Kab. Seruyan,5,1,0,0,0,6
Kec. Danau Sembuluh Kab. Seruyan,1,1,0,0,0,2
Kec. Hanau Kab. Seruyan,0,0,0,0,0,0
Kec. Seruyan Tengah Kab. Seruyan,0,0,0,0,0,0
Kec. Seruyan Hulu Kab. Seruyan,0,0,0,0,0,0
Kec. Seruyan Hilir Timur Kab. Seruyan,2,0,0,0,0,2
Kec. Seruyan Raya Kab. Seruyan,2,0,0,0,0,2
Kec. Danau Seluluk Kab. Seruyan,0,0,0,0,0,0
Kec. Batu Ampar Kab. Seruyan,2,0,0,0,0,2
Kec. Jelai Kab. Sukamara,2,0,0,0,0,2
Kec. Sukamara Kab. Sukamara,2,0,0,0,0,2
Kec. Balai Riam Kab. Sukamara,2,0,0,0,0,2
Kec. Pantai Lunci Kab. Sukamara,0,0,0,0,0,0
Kec. Permata Kecubung Kab. Sukamara,0,0,0,0,0,0
Kec. Montallat Kab. Barito Utara,1,1,0,0,0,2
Kec. Gunung Timang Kab. Barito Utara,2,0,0,0,0,2
Kec. Teweh Timur Kab. Barito Utara,0,0,0,0,0,0
Kec. Teweh Tengah Kab. Barito Utara,1,1,0,0,0,2
Kec. Lahei Kab. Barito Utara,2,0,0,0,0,2
Kec. Teweh Baru Kab. Barito Utara,2,0,0,0,0,2
Kec. Teweh Selatan Kab. Barito Utara,0,0,0,0,0,0
Kec. Lahei Barat Kab. Barito Utara,3,1,0,0,0,4
Kec. Mentaya Hilir Selatan Kab. Kotawaringin Timur,4,0,0,0,0,4
Kec. Pulau Hanaut Kab. Kotawaringin Timur,0,0,0,0,0,0
Kec. Mentawa Baru Ketapang Kab. Kotawaringin Timur,9,3,0,0,0,12
Kec. Mentaya Hilir Utara Kab. Kotawaringin Timur,2,2,0,0,0,4
Kec. Kota Besi Kab. Kotawaringin Timur,1,1,0,0,0,2
Kec. Baamang Kab. Kotawaringin Timur,6,0,0,0,0,6
Kec. Cempaga Kab. Kotawaringin Timur,1,1,0,0,0,2
Kec. Parenggean Kab. Kotawaringin Timur,1,1,0,0,0,2
Kec. Mentaya Hulu Kab. Kotawaringin Timur,3,1,0,0,0,4
Kec. Antang Kalang Kab. Kotawaringin Timur,1,1,0,0,0,2
Kec. Seranau Kab. Kotawaringin Timur,0,0,0,0,0,0
Kec. Cempaga Hulu Kab. Kotawaringin Timur,2,0,0,0,0,2
Kec. Telaga Antang Kab. Kotawaringin Timur,0,0,0,0,0,0
Kec. Kotawaringin Lama Kab. Kotawaringin Barat,0,2,0,0,0,2
Kec. Arut Selatan Kab. Kotawaringin Barat,10,4,0,0,0,14
Kec. Kumai Kab. Kotawaringin Barat,6,0,0,0,0,6
Kec. Arut Utara Kab. Kotawaringin Barat,0,2,0,0,0,2
Kec. Pangkalan Banteng Kab. Kotawaringin Barat,4,0,0,0,0,4
Kec. Pangkalan Lada Kab. Kotawaringin Barat,2,0,0,0,0,2
Kec. Bulik Kab. Lamandau,6,2,0,0,0,8
Kec. Lamandau Kab. Lamandau,1,1,0,0,0,2
Kec. Delang Kab. Lamandau,1,1,0,0,0,2
Kec. Bulik Timur Kab. Lamandau,0,0,0,0,0,0
Kec. Mentobi Raya Kab. Lamandau,0,2,0,0,0,2
Kec. Sematu Jaya Kab. Lamandau,0,4,0,0,0,4
Kec. Belantikan Raya Kab. Lamandau,1,1,0,0,0,2
Kec. Batang Kawa Kab. Lamandau,0,0,0,0,0,0
Kec. Tewah Kab. Gunung Mas,4,1,0,0,0,5
Kec. Kurun Kab. Gunung Mas,3,3,0,0,0,6
Kec. Sepang Kab. Gunung Mas,1,1,0,0,0,2
Kec. Rungan Kab. Gunung Mas,1,1,0,0,0,2
Kec. Manuhing Kab. Gunung Mas,0,0,0,0,0,0
Kec. Kahayan Hulu Utara Kab. Gunung Mas,1,1,0,0,0,2
Kec. Mihing Raya Kab. Gunung Mas,0,0,0,0,0,0
Kec. Damang Batu Kab. Gunung Mas,0,0,0,0,0,0
Kec. Miri Manasa Kab. Gunung Mas,2,0,0,0,0,2
Kec. Manuhing Raya Kab. Gunung Mas,0,0,0,0,0,0
Kec. Rungan Barat Kab. Gunung Mas,0,0,0,0,0,0
Kec. Kahayan Kuala Kab. Pulang Pisau,2,1,0,0,0,3
Kec. Pandih Batu Kab. Pulang Pisau,1,1,0,0,0,2
Kec. Maliku Kab. Pulang Pisau,2,2,0,0,0,4
Kec. Kahayan Hilir Kab. Pulang Pisau,5,1,0,0,0,6
Kec. Kahayan Tengah Kab. Pulang Pisau,6,0,0,0,0,6
Kec. Banama Tingan Kab. Pulang Pisau,0,0,0,0,0,0
Kec. Sebangau Kuala Kab. Pulang Pisau,2,0,0,0,0,2
Kec. Jabiren Raya Kab. Pulang Pisau,0,0,0,0,0,0
Kec. Laung Tuhup Kab. Murung Raya,1,3,0,0,0,4
Kec. Murung Kab. Murung Raya,10,2,0,0,0,12
Kec. Permata Intan Kab. Murung Raya,0,0,0,0,0,0
Kec. Tanah Siang Kab. Murung Raya,2,0,0,0,0,2
Kec. Sumber Barito Kab. Murung Raya,0,2,0,0,0,2
Kec. Barito Tuhup Raya Kab. Murung Raya,0,0,0,0,0,0
Kec. Tanah Siang Selatan Kab. Murung Raya,2,0,0,0,0,2
Kec. Sungai Babuat Kab. Murung Raya,0,0,0,0,0,0
Kec. Seribu Riam Kab. Murung Raya,0,0,0,0,0,0
Kec. Uut Murung Kab. Murung Raya,0,0,0,0,0,0
Kec. Aluh-Aluh Kab. Banjar,3,1,0,0,0,4
Kec. Gambut Kab. Banjar,4,0,0,0,0,4
Kec. Kertak Hanyar Kab. Banjar,1,0,0,0,0,1
Kec. Sungai Tabuk Kab. Banjar,1,1,0,0,0,2
Kec. Martapura Kab. Banjar,12,2,0,0,0,14
Kec. Karang Intan Kab. Banjar,3,1,0,0,0,4
Kec. Pengaron Kab. Banjar,0,0,0,0,0,0
Kec. Mataraman Kab. Banjar,2,0,0,0,0,2
Kec. Beruntung Baru Kab. Banjar,0,0,0,0,0,0
Kec. Martapura Barat Kab. Banjar,0,0,0,0,0,0
Kec. Paramasan Kab. Banjar,0,0,0,0,0,0
Kec. Sambung Makmur Kab. Banjar,2,0,0,0,0,2
Kec. Binuang Kab. Tapin,2,4,0,0,0,6
Kec. Tapin Selatan Kab. Tapin,0,0,0,0,0,0
Kec. Tapin Tengah Kab. Tapin,0,0,0,0,0,0
Kec. Tapin Utara Kab. Tapin,2,0,0,0,0,2
Kec. Candi Laras Selatan Kab. Tapin,0,0,0,0,0,0
Kec. Salam Babaris Kab. Tapin,0,0,0,0,0,0
Kec. Loksado Kab. Hulu Sungai Selatan,0,0,0,0,0,0
Kec. Telaga Langsat Kab. Hulu Sungai Selatan,2,0,0,0,0,2
Kec. Angkinang Kab. Hulu Sungai Selatan,0,0,0,0,0,0
Kec. Kandangan Kab. Hulu Sungai Selatan,5,1,0,0,0,6
Kec. Sungai Raya Kab. Hulu Sungai Selatan,2,0,0,0,0,2
Kec. Simpur Kab. Hulu Sungai Selatan,2,0,0,0,0,2
Kec. Daha Utara Kab. Hulu Sungai Selatan,4,0,0,0,0,4
Kec. Daha Barat Kab. Hulu Sungai Selatan,0,0,0,0,0,0
Kec. Haruyan Kab. Hulu Sungai Tengah,2,2,0,0,0,4
Kec. Batang Alai Selatan Kab. Hulu Sungai Tengah,2,0,0,0,0,2
Kec. Barabai Kab. Hulu Sungai Tengah,4,2,0,0,0,6
Kec. Labuan Amas Selatan Kab. Hulu Sungai Tengah,1,1,0,0,0,2
Kec. Labuan Amas Utara Kab. Hulu Sungai Tengah,2,0,0,0,0,2
Kec. Pandawan Kab. Hulu Sungai Tengah,2,0,0,0,0,2
Kec. Batang Alai Utara Kab. Hulu Sungai Tengah,0,0,0,0,0,0
Kec. Batang Alai Timur Kab. Hulu Sungai Tengah,1,1,0,0,0,2
Kec. Kusan Hilir Kab. Tanah Bumbu,4,0,0,0,0,4
Kec. Sungai Loban Kab. Tanah Bumbu,2,0,0,0,0,2
Kec. Satui Kab. Tanah Bumbu,2,0,0,0,0,2
Kec. Kusan Hulu Kab. Tanah Bumbu,0,0,0,0,0,0
Kec. Batu Licin Kab. Tanah Bumbu,0,0,0,0,0,0
Kec. Simpang Empat Kab. Tanah Bumbu,4,0,0,0,0,4
Kec. Karang Bintang Kab. Tanah Bumbu,3,0,0,0,0,3
Kec. Mantewe Kab. Tanah Bumbu,2,0,0,0,0,2
Kec. Angsana Kab. Tanah Bumbu,2,0,0,0,0,2
Kec. Kuranji Kab. Tanah Bumbu,0,0,0,0,0,0
Kec. Banjarmasin Selatan Kota Banjarmasin,11,1,0,0,0,12
Kec. Banjarmasin Timur Kota Banjarmasin,9,1,0,0,0,10
Kec. Banjarmasin Barat Kota Banjarmasin,6,4,0,0,0,10
Kec. Banjarmasin Utara Kota Banjarmasin,15,1,0,0,0,16
Kec. Banjarmasin Tengah Kota Banjarmasin,9,3,0,0,0,12
Kec. Landasan Ulin Kota Banjarbaru,0,0,0,0,0,0
Kec. Cempaka Kota Banjarbaru,2,0,0,0,0,2
Kec. Banjarbaru Utara Kota Banjarbaru,11,3,0,0,0,14
Kec. Banjarbaru Selatan Kota Banjarbaru,4,0,0,0,0,4
Kec. Liang Anggang Kota Banjarbaru,4,0,0,0,0,4
Kec. Danau Panggang Kab. Hulu Sungai Utara,6,0,0,0,0,6
Kec. Sungai Pandan Kab. Hulu Sungai Utara,0,0,0,0,0,0
Kec. Amuntai Tengah Kab. Hulu Sungai Utara,6,0,0,0,0,6
Kec. Banjang Kab. Hulu Sungai Utara,0,0,0,0,0,0
Kec. Amuntai Utara Kab. Hulu Sungai Utara,1,1,0,0,0,2
Kec. Paminggir Kab. Hulu Sungai Utara,0,0,0,0,0,0
Kec. Sungai Tabukan Kab. Hulu Sungai Utara,0,0,0,0,0,0
Kec. Kelua Kab. Tabalong,1,1,0,0,0,2
Kec. Muara Harus Kab. Tabalong,1,1,0,0,0,2
Kec. Tanta Kab. Tabalong,0,0,0,0,0,0
Kec. Tanjung Kab. Tabalong,0,0,0,0,0,0
Kec. Murung Pudak Kab. Tabalong,0,4,0,0,0,4
Kec. Haruai Kab. Tabalong,0,0,0,0,0,0
Kec. Upau Kab. Tabalong,1,1,0,0,0,2
Kec. Muara Uya Kab. Tabalong,3,1,0,0,0,4
Kec. Jaro Kab. Tabalong,1,1,0,0,0,2
Kec. Bintang Ara Kab. Tabalong,3,1,0,0,0,4
Kec. Pulau Sembilan Kab. Kotabaru,2,0,0,0,0,2
Kec. Pulau Laut Barat Kab. Kotabaru,0,0,0,0,0,0
Kec. Pulau Laut Selatan Kab. Kotabaru,0,0,0,0,0,0
Kec. Pulau Laut Timur Kab. Kotabaru,0,0,0,0,0,0
Kec. Pulau Sebuku Kab. Kotabaru,2,0,0,0,0,2
Kec. Pulau Laut Utara Kab. Kotabaru,2,2,0,0,0,4
Kec. Pulau Laut Tengah Kab. Kotabaru,2,0,0,0,0,2
Kec. Kelumpang Hilir Kab. Kotabaru,3,1,0,0,0,4
Kec. Kelumpang Barat Kab. Kotabaru,0,0,0,0,0,0
Kec. Kelumpang Selatan Kab. Kotabaru,2,0,0,0,0,2
Kec. Kelumpang Hulu Kab. Kotabaru,1,1,0,0,0,2
Kec. Hampang Kab. Kotabaru,0,0,0,0,0,0
Kec. Kelumpang Tengah Kab. Kotabaru,0,0,0,0,0,0
Kec. Kelumpang Utara Kab. Kotabaru,2,0,0,0,0,2
Kec. Pamukan Selatan Kab. Kotabaru,0,0,0,0,0,0
Kec. Sampanahan Kab. Kotabaru,2,0,0,0,0,2
Kec. Pamukan Utara Kab. Kotabaru,0,0,0,0,0,0
Kec. Pulau Laut Kepulauan Kab. Kotabaru,3,1,0,0,0,4
Kec. Pamukan Barat Kab. Kotabaru,0,0,0,0,0,0
Kec. Lampihong Kab. Balangan,0,0,0,0,0,0
Kec. Awayan Kab. Balangan,1,1,0,0,0,2
Kec. Paringin Kab. Balangan,1,1,0,0,0,2
Kec. Juai Kab. Balangan,4,0,0,0,0,4
Kec. Halong Kab. Balangan,2,0,0,0,0,2
Kec. Tebing Tinggi Kab. Balangan,0,0,0,0,0,0
Kec. Paringin Selatan Kab. Balangan,5,1,0,0,0,6
Kec. Panyipatan Kab. Tanah Laut,2,0,0,0,0,2
Kec. Takisung Kab. Tanah Laut,0,0,0,0,0,0
Kec. Kurau Kab. Tanah Laut,1,1,0,0,0,2
Kec. Bati-Bati Kab. Tanah Laut,4,0,0,0,0,4
Kec. Tambang Ulang Kab. Tanah Laut,2,0,0,0,0,2
Kec. Pelaihari Kab. Tanah Laut,0,4,0,0,0,4
Kec. Batu Ampar Kab. Tanah Laut,1,1,0,0,0,2
Kec. Jorong Kab. Tanah Laut,0,0,0,0,0,0
Kec. Kintap Kab. Tanah Laut,4,0,0,0,0,4
Kec. Bumi Makmur Kab. Tanah Laut,0,0,0,0,0,0
Kec. Bajuin Kab. Tanah Laut,0,0,0,0,0,0
Kec. Tabunganen Kab. Barito Kuala,0,2,0,0,0,2
Kec. Tamban Kab. Barito Kuala,2,0,0,0,0,2
Kec. Mekarsari Kab. Barito Kuala,0,1,0,0,0,1
Kec. Anjir Pasar Kab. Barito Kuala,2,0,0,0,0,2
Kec. Anjir Muara Kab. Barito Kuala,0,2,0,0,0,2
Kec. Alalak Kab. Barito Kuala,4,0,0,0,0,4
Kec. Mandastana Kab. Barito Kuala,0,0,0,0,0,0
Kec. Belawang Kab. Barito Kuala,0,0,0,0,0,0
Kec. Wanaraya Kab. Barito Kuala,2,0,0,0,0,2
Kec. Barambai Kab. Barito Kuala,0,0,0,0,0,0
Kec. Rantau Badauh Kab. Barito Kuala,1,1,0,0,0,2
Kec. Bakumpai Kab. Barito Kuala,2,0,0,0,0,2
Kec. Marabahan Kab. Barito Kuala,1,1,0,0,0,2
Kec. Tabukan Kab. Barito Kuala,1,1,0,0,0,2
Kec. Kuripan Kab. Barito Kuala,2,0,0,0,0,2
Kec. Jejangkit Kab. Barito Kuala,0,0,0,0,0,0
Kec. Bongan Kab. Kutai Barat,4,0,0,0,0,4
Kec. Jempang Kab. Kutai Barat,0,0,0,0,0,0
Kec. Penyinggahan Kab. Kutai Barat,1,1,0,0,0,2
Kec. Muara Pahu Kab. Kutai Barat,0,0,0,0,0,0
Kec. Muara Lawa Kab. Kutai Barat,0,0,0,0,0,0
Kec. Damai Kab. Kutai Barat,0,0,0,0,0,0
Kec. Barong Tongkok Kab. Kutai Barat,3,0,0,0,0,3
Kec. Melak Kab. Kutai Barat,2,0,0,0,0,2
Kec. Long Iram Kab. Kutai Barat,1,1,0,0,0,2
Kec. Bentian Besar Kab. Kutai Barat,0,0,0,0,0,0
Kec. Linggang Bingung Kab. Kutai Barat,1,1,0,0,0,2
Kec. Mook Manaar Bulatn Kab. Kutai Barat,4,0,0,0,0,4
Kec. Nyuatan Kab. Kutai Barat,0,0,0,0,0,0
Kec. Sekolaq Darat Kab. Kutai Barat,4,0,0,0,0,4
Kec. Tering Kab. Kutai Barat,0,0,0,0,0,0
Kec. Siluq Ngurai Kab. Kutai Barat,4,0,0,0,0,4
Kec. Muara Ancalong Kab. Kutai Timur,2,2,0,0,0,4
Kec. Muara Wahau Kab. Kutai Timur,2,0,0,0,0,2
Kec. Muara Bengkal Kab. Kutai Timur,1,1,0,0,0,2
Kec. Sangatta Utara Kab. Kutai Timur,3,1,0,0,0,4
Kec. Sangkulirang Kab. Kutai Timur,4,0,0,0,0,4
Kec. Kaliorang Kab. Kutai Timur,0,0,0,0,0,0
Kec. Kongbeng Kab. Kutai Timur,4,0,0,0,0,4
Kec. Bengalon Kab. Kutai Timur,4,0,0,0,0,4
Kec. Busang Kab. Kutai Timur,0,0,0,0,0,0
Kec. Sandaran Kab. Kutai Timur,0,0,0,0,0,0
Kec. Sangatta Selatan Kab. Kutai Timur,2,0,0,0,0,2
Kec. Teluk Pandan Kab. Kutai Timur,4,0,0,0,0,4
Kec. Rantau Pulung Kab. Kutai Timur,3,1,0,0,0,4
Kec. Kaubun Kab. Kutai Timur,2,0,0,0,0,2
Kec. Karangan Kab. Kutai Timur,1,0,0,0,0,1
Kec. Batu Ampar Kab. Kutai Timur,0,0,0,0,0,0
Kec. Long Mesangat Kab. Kutai Timur,3,1,0,0,0,4
Kec. Batu Sopang Kab. Paser,1,1,0,0,0,2
Kec. Tanjung Harapan Kab. Paser,0,0,0,0,0,0
Kec. Paser Belengkong Kab. Paser,3,1,0,0,0,4
Kec. Tanah Grogot Kab. Paser,2,4,0,0,0,6
Kec. Kuaro Kab. Paser,1,1,0,0,0,2
Kec. Long Ikis Kab. Paser,2,1,0,0,0,3
Kec. Muara Komam Kab. Paser,0,0,0,0,0,0
Kec. Long Kali Kab. Paser,4,0,0,0,0,4
Kec. Muara Samu Kab. Paser,0,0,0,0,0,0
Kec. Batu Engau Kab. Paser,4,0,0,0,0,4
Kec. Babulu Kab. Penajam Paser Utara,0,0,0,0,0,0
Kec. Waru Kab. Penajam Paser Utara,2,0,0,0,0,2
Kec. Penajam Kab. Penajam Paser Utara,6,2,0,0,0,8
Kec. Sepaku Kab. Penajam Paser Utara,2,2,0,0,0,4
KEC. LONG HUBUNG Kab. Mahakam Ulu,3,1,0,0,0,4
KEC. LAHAM Kab. Mahakam Ulu,0,0,0,0,0,0
KEC. LONG APARI Kab. Mahakam Ulu,0,2,0,0,0,2
KEC. LONG PAHANGAI Kab. Mahakam Ulu,4,0,0,0,0,4
KEC. LONG BAGUN Kab. Mahakam Ulu,1,1,0,0,0,2
Kec. Palaran Kota Samarinda,2,2,0,0,0,4
Kec. Samarinda Ilir Kota Samarinda,2,0,0,0,0,2
Kec. Samarinda Seberang Kota Samarinda,1,1,0,0,0,2
Kec. Sungai Kunjang Kota Samarinda,6,2,0,0,0,8
Kec. Samarinda Ulu Kota Samarinda,18,4,0,0,0,22
Kec. Samarinda Utara Kota Samarinda,7,3,0,0,0,10
Kec. Sambutan Kota Samarinda,3,1,0,0,0,4
Kec. Sungai Pinang Kota Samarinda,13,1,0,0,0,14
Kec. Samarinda Kota Kota Samarinda,9,1,0,0,0,10
Kec. Loa Janan Ilir Kota Samarinda,8,2,0,0,0,10
Kec. Balikpapan Selatan Kota Balikpapan,3,1,0,0,0,4
Kec. Balikpapan Timur Kota Balikpapan,2,0,0,0,0,2
Kec. Balikpapan Utara Kota Balikpapan,13,4,0,0,0,17
Kec. Balikpapan Tengah Kota Balikpapan,10,2,0,0,0,12
Kec. Balikpapan Barat Kota Balikpapan,2,2,0,0,0,4
Kec. Balikpapan Kota Kota Balikpapan,9,1,0,0,0,10
Kec. Bontang Selatan Kota Bontang,7,1,0,0,0,8
Kec. Bontang Utara Kota Bontang,8,2,0,0,0,10
Kec. Bontang Barat Kota Bontang,12,0,0,0,0,12
Kec. Samboja Kab. Kutai Kartanegara,9,3,0,0,0,12
Kec. Muara Jawa Kab. Kutai Kartanegara,3,1,0,0,0,4
Kec. Sanga-Sanga Kab. Kutai Kartanegara,4,0,0,0,0,4
Kec. Loa Janan Kab. Kutai Kartanegara,4,0,0,0,0,4
Kec. Loa Kulu Kab. Kutai Kartanegara,1,1,0,0,0,2
Kec. Muara Muntai Kab. Kutai Kartanegara,4,0,0,0,0,4
Kec. Muara Wis Kab. Kutai Kartanegara,2,0,0,0,0,2
Kec. Kota Bangun Kab. Kutai Kartanegara,4,0,0,0,0,4
Kec. Tenggarong Kab. Kutai Kartanegara,9,3,0,0,0,12
Kec. Sebulu Kab. Kutai Kartanegara,3,3,0,0,0,6
Kec. Tenggarong Seberang Kab. Kutai Kartanegara,13,3,0,0,0,16
Kec. Anggana Kab. Kutai Kartanegara,1,1,0,0,0,2
Kec. Muara Badak Kab. Kutai Kartanegara,2,2,0,0,0,4
Kec. Marang Kayu Kab. Kutai Kartanegara,6,0,0,0,0,6
Kec. Muara Kaman Kab. Kutai Kartanegara,5,1,0,0,0,6
Kec. Kenohan Kab. Kutai Kartanegara,0,0,0,0,0,0
Kec. Kembang Janggut Kab. Kutai Kartanegara,10,0,0,0,0,10
Kec. Tabang Kab. Kutai Kartanegara,1,1,0,0,0,2
Kec. Talisayan Kab. Berau,4,2,0,0,0,6
Kec. Biduk Biduk Kab. Berau,1,1,0,0,0,2
Kec. Sambaliung Kab. Berau,2,2,0,0,0,4
Kec. Tanjung Redeb Kab. Berau,8,2,0,0,0,10
Kec. Gunung Tabur Kab. Berau,2,0,0,0,0,2
Kec. Teluk Bayur Kab. Berau,4,0,0,0,0,4
Kec. Pulau Maratua Kab. Berau,0,0,0,0,0,0
Kec. Batu Putih Kab. Berau,0,0,0,0,0,0
Kec. Biatan Kab. Berau,0,0,0,0,0,0
Kec. Malalayang Kota Manado,4,4,0,0,0,8
Kec. Sario Kota Manado,10,4,0,0,0,14
Kec. Wenang Kota Manado,13,3,0,0,0,16
Kec. Mapanget Kota Manado,4,2,0,0,0,6
Kec. Bunaken Kota Manado,0,0,0,0,0,0
Kec. Wanea Kota Manado,5,3,0,0,0,8
Kec. Tikala Kota Manado,4,4,0,0,0,8
Kec. Tuminting Kota Manado,2,0,0,0,0,2
Kec. Singkil Kota Manado,6,0,0,0,0,6
Kec. Ranowulu Kota Bitung,1,1,0,0,0,2
Kec. Matuari Kota Bitung,0,0,0,0,0,0
Kec. Girian Kota Bitung,3,1,0,0,0,4
Kec. Madidir Kota Bitung,7,1,0,0,0,8
Kec. Maesa Kota Bitung,5,1,0,0,0,6
Kec. Aertembaga Kota Bitung,2,0,0,0,0,2
Kec. Lembeh Utara Kota Bitung,2,0,0,0,0,2
Kec. Lembeh Selatan Kota Bitung,0,2,0,0,0,2
Kec. Tomohon Utara Kota Tomohon,6,0,0,0,0,6
Kec. Tomohon Tengah Kota Tomohon,8,0,0,0,0,8
Kec. Tomohon Selatan Kota Tomohon,6,0,0,0,0,6
Kec. Tomohon Timur Kota Tomohon,6,0,0,0,0,6
Kec. Tomohon Barat Kota Tomohon,3,1,0,0,0,4
Kec. Kotamobagu Barat Kota Kotamobagu,7,1,0,0,0,8
Kec. Kotamobagu Utara Kota Kotamobagu,5,1,0,0,0,6
Kec. Langowan Timur Kab. Minahasa,0,0,0,0,0,0
Kec. Tompaso Kab. Minahasa,6,0,0,0,0,6
Kec. Kawangkoan Kab. Minahasa,2,0,0,0,0,2
Kec. Sonder Kab. Minahasa,0,0,0,0,0,0
Kec. Tombariri Kab. Minahasa,0,0,0,0,0,0
Kec. Pineleng Kab. Minahasa,6,0,0,0,0,6
Kec. Tondano Timur Kab. Minahasa,1,1,0,0,0,2
Kec. Remboken Kab. Minahasa,0,0,0,0,0,0
Kec. Kakas Kab. Minahasa,0,0,0,0,0,0
Kec. Eris Kab. Minahasa,0,0,0,0,0,0
Kec. Kombi Kab. Minahasa,2,0,0,0,0,2
Kec. Tombulu Kab. Minahasa,0,0,0,0,0,0
Kec. Tondano Barat Kab. Minahasa,2,2,0,0,0,4
Kec. Tondano Utara Kab. Minahasa,0,0,0,0,0,0
Kec. Tondano Selatan Kab. Minahasa,2,0,0,0,0,2
Kec. Langowan Utara Kab. Minahasa,2,0,0,0,0,2
Kec. Kawangkoan Barat Kab. Minahasa,0,0,0,0,0,0
Kec. Tompaso Barat Kab. Minahasa,2,0,0,0,0,2
Kec. Kauditan Kab. Minahasa Utara,3,1,0,0,0,4
Kec. Airmadidi Kab. Minahasa Utara,4,0,0,0,0,4
Kec. Dimembe Kab. Minahasa Utara,1,1,0,0,0,2
Kec. Wori Kab. Minahasa Utara,2,0,0,0,0,2
Kec. Likupang Timur Kab. Minahasa Utara,0,0,0,0,0,0
Kec. Kema Kab. Minahasa Utara,3,1,0,0,0,4
Kec. Likupang Barat Kab. Minahasa Utara,4,0,0,0,0,4
Kec. Kalawat Kab. Minahasa Utara,2,0,0,0,0,2
Kec. Talawaan Kab. Minahasa Utara,0,0,0,0,0,0
Kec. Likupang Selatan Kab. Minahasa Utara,1,1,0,0,0,2
Kec. Bintauna Kab. Bolaang Mongondow Utara,2,0,0,0,0,2
Kec. Bolaang Itang Timur Kab. Bolaang Mongondow Utara,0,0,0,0,0,0
Kec. Bolaang Itang Barat Kab. Bolaang Mongondow Utara,4,0,0,0,0,4
Kec. Pinogaluman Kab. Bolaang Mongondow Utara,0,0,0,0,0,0
Kec. Manganitu Selatan Kab. Kep. Sangihe,0,0,0,0,0,0
Kec. Tamako Kab. Kep. Sangihe,2,0,0,0,0,2
Kec. Tabukan Selatan Kab. Kep. Sangihe,2,0,0,0,0,2
Kec. Tabukan Tengah Kab. Kep. Sangihe,0,0,0,0,0,0
Kec. Manganitu Kab. Kep. Sangihe,2,0,0,0,0,2
Kec. Tahuna Kab. Kep. Sangihe,2,0,0,0,0,2
Kec. Tabukan Utara Kab. Kep. Sangihe,1,1,0,0,0,2
Kec. Kendahe Kab. Kep. Sangihe,0,0,0,0,0,0
Kec. Tatoareng Kab. Kep. Sangihe,0,0,0,0,0,0
Kec. Nusa Tabukan Kab. Kep. Sangihe,0,0,0,0,0,0
Kec. Tabukan Selatan Tenggara Kab. Kep. Sangihe,0,0,0,0,0,0
Kec. Tahuna Timur Kab. Kep. Sangihe,6,0,0,0,0,6
Kec. Tahuna Barat Kab. Kep. Sangihe,2,0,0,0,0,2
Kec. Kepulauan Marore Kab. Kep. Sangihe,2,0,0,0,0,2
Kec. Kabaruan Kab. Kepulauan Talaud,2,0,0,0,0,2
Kec. Lirung Kab. Kepulauan Talaud,0,0,0,0,0,0
Kec. Melonguane Kab. Kepulauan Talaud,2,0,0,0,0,2
Kec. Beo Kab. Kepulauan Talaud,5,1,0,0,0,6
Kec. Rainis Kab. Kepulauan Talaud,0,1,0,0,0,1
Kec. Essang Kab. Kepulauan Talaud,0,0,0,0,0,0
Kec. Nanusa Kab. Kepulauan Talaud,0,0,0,0,0,0
Kec. Gemeh Kab. Kepulauan Talaud,0,0,0,0,0,0
Kec. Tanpa Namma Kab. Kepulauan Talaud,0,0,0,0,0,0
Kec. Moronge Kab. Kepulauan Talaud,0,0,0,0,0,0
Kec. Melonguane Timur Kab. Kepulauan Talaud,1,0,1,0,0,2
Kec. Beo Utara Kab. Kepulauan Talaud,0,0,0,0,0,0
Kec. Beo Selatan Kab. Kepulauan Talaud,0,0,0,0,0,0
Kec. Essang Selatan Kab. Kepulauan Talaud,0,0,0,0,0,0
Kec. Salibabu Kab. Kepulauan Talaud,0,2,0,0,0,2
Kec. Modoinding Kab. Minahasa Selatan,0,0,0,0,0,0
Kec. Ranoyapo Kab. Minahasa Selatan,0,0,0,0,0,0
Kec. Motoling Kab. Minahasa Selatan,2,0,0,0,0,2
Kec. Tenga Kab. Minahasa Selatan,1,1,0,0,0,2
Kec. Amurang Kab. Minahasa Selatan,4,0,0,0,0,4
Kec. Tareran Kab. Minahasa Selatan,2,2,0,0,0,4
Kec. Kumelembuai Kab. Minahasa Selatan,0,0,0,0,0,0
Kec. Maesaan Kab. Minahasa Selatan,1,1,0,0,0,2
Kec. Amurang Barat Kab. Minahasa Selatan,0,0,0,0,0,0
Kec. Amurang Timur Kab. Minahasa Selatan,0,0,0,0,0,0
Kec. Tatapan Kab. Minahasa Selatan,0,0,0,0,0,0
Kec. Motoling Barat Kab. Minahasa Selatan,0,0,0,0,0,0
Kec. Motoling Timur Kab. Minahasa Selatan,0,0,0,0,0,0
Kec. Suluun Tareran Kab. Minahasa Selatan,0,0,0,0,0,0
Kec. Tumpaan Kab. Minahasa Selatan,0,0,0,0,0,0
Kec. Sinonsayang Kab. Minahasa Selatan,0,0,0,0,0,0
Kec. Lolayan Kab. Bolaang Mongondow,4,0,0,0,0,4
Kec. Poigar Kab. Bolaang Mongondow,0,0,0,0,0,0
Kec. Bolaang Kab. Bolaang Mongondow,1,1,0,0,0,2
Kec. Lolak Kab. Bolaang Mongondow,0,0,0,0,0,0
Kec. Sangtombolang Kab. Bolaang Mongondow,1,1,0,0,0,2
Kec. Dumoga Utara Kab. Bolaang Mongondow,1,1,0,0,0,2
Kec. Dumoga Barat Kab. Bolaang Mongondow,2,0,0,0,0,2
Kec. Dumoga Timur Kab. Bolaang Mongondow,1,1,0,0,0,2
Kec. Passi Barat Kab. Bolaang Mongondow,0,0,0,0,0,0
Kec. Siau Barat Kab. Kepulauan Siau Tagulandang Biaro,0,0,0,0,0,0
Kec. Siau Timur Kab. Kepulauan Siau Tagulandang Biaro,0,0,0,0,0,0
Kec. Tagulandang Kab. Kepulauan Siau Tagulandang Biaro,1,1,0,0,0,2
Kec. Ratatotok Kab. Minahasa Tenggara,0,0,0,0,0,0
Kec. Pusomaen Kab. Minahasa Tenggara,0,0,0,0,0,0
Kec. Belang Kab. Minahasa Tenggara,0,0,0,0,0,0
Kec. Ratahan Kab. Minahasa Tenggara,2,2,0,0,0,4
Kec. Tombatu Kab. Minahasa Tenggara,2,0,0,0,0,2
Kec. Touluaan Kab. Minahasa Tenggara,2,0,0,0,0,2
Kec. Touluaan Selatan Kab. Minahasa Tenggara,0,0,0,0,0,0
Kec. Ratahan Timur Kab. Minahasa Tenggara,0,0,0,0,0,0
Kec. Kotabunan Kab. Bolaang Mongondow Timur,2,0,0,0,0,2
Kec. Tutuyan Kab. Bolaang Mongondow Timur,1,1,0,0,0,2
Kec. Modayag Kab. Bolaang Mongondow Timur,1,1,0,0,0,2
Kec. Bolaang Uki Kab. Bolaang Mongondow Selatan,4,0,0,0,0,4
Kec. Posigadan Kab. Bolaang Mongondow Selatan,0,2,0,0,0,2
Kec. Pinolosian Kab. Bolaang Mongondow Selatan,1,1,0,0,0,2
Kec. Pinolosian Timur Kab. Bolaang Mongondow Selatan,0,0,0,0,0,0
Kec. Totikum Kab. Banggai Kepulauan,2,0,0,0,0,2
Kec. Tinangkung Kab. Banggai Kepulauan,0,0,0,0,0,0
Kec. Liang Kab. Banggai Kepulauan,0,0,0,0,0,0
Kec. Bulagi Kab. Banggai Kepulauan,0,2,0,0,0,2
Kec. Buko Kab. Banggai Kepulauan,2,0,0,0,0,2
Kec. Bulagi Selatan Kab. Banggai Kepulauan,0,0,0,0,0,0
Kec. Tinangkung Selatan Kab. Banggai Kepulauan,0,0,0,0,0,0
Kec. Tinangkung Utara Kab. Banggai Kepulauan,0,0,0,0,0,0
Kec. Peling Tengah Kab. Banggai Kepulauan,0,0,0,0,0,0
Kec. Bulagi Utara Kab. Banggai Kepulauan,0,0,0,0,0,0
Kec. Buko Selatan Kab. Banggai Kepulauan,0,0,0,0,0,0
Kec. Totikum Selatan Kab. Banggai Kepulauan,0,0,0,0,0,0
Kec. Tojo Kab. Tojo Una-Una,2,0,0,0,0,2
Kec. Ulubongka Kab. Tojo Una-Una,0,0,0,0,0,0
Kec. Ampana Tete Kab. Tojo Una-Una,0,0,0,0,0,0
Kec. Ampana Kota Kab. Tojo Una-Una,3,1,0,0,0,4
Kec. Una - Una Kab. Tojo Una-Una,0,0,0,0,0,0
Kec. Walea Kepulauan Kab. Tojo Una-Una,0,0,0,0,0,0
Kec. Togean Kab. Tojo Una-Una,0,0,0,0,0,0
Kec. Walea Besar Kab. Tojo Una-Una,0,0,0,0,0,0
Kec. Batudaka Kab. Tojo Una-Una,0,0,0,0,0,0
Kec. Kulawi Kab. Sigi,0,0,0,0,0,0
Kec. Pipikoro Kab. Sigi,0,0,0,0,0,0
Kec. Lindu Kab. Sigi,0,0,0,0,0,0
Kec. Palolo Kab. Sigi,2,0,0,0,0,2
Kec. Dolo Kab. Sigi,0,0,0,0,0,0
Kec. Dolo Selatan Kab. Sigi,0,0,0,0,0,0
Kec. Dolo Barat Kab. Sigi,0,0,0,0,0,0
Kec. Marawola Kab. Sigi,0,0,0,0,0,0
Kec. Kinovaro Kab. Sigi,0,0,0,0,0,0
Kec. Marawola Barat Kab. Sigi,0,0,0,0,0,0
Kec. Sigibiromaru Kab. Sigi,1,1,0,0,0,2
Kec. Gumbasa Kab. Sigi,0,0,0,0,0,0
Kec. Tanambulava Kab. Sigi,2,0,0,0,0,2
Kec. Toili Kab. Banggai,0,2,0,0,0,2
Kec. Batui Kab. Banggai,1,1,0,0,0,2
Kec. Bunta Kab. Banggai,2,0,0,0,0,2
Kec. Kintom Kab. Banggai,1,1,0,0,0,2
Kec. Luwuk Kab. Banggai,8,2,0,0,0,10
Kec. Pagimana Kab. Banggai,0,2,0,0,0,2
Kec. Lamala Kab. Banggai,4,0,0,0,0,4
Kec. Balantak Kab. Banggai,0,0,0,0,0,0
Kec. Bualemo Kab. Banggai,0,0,0,0,0,0
Kec. Toili Barat Kab. Banggai,0,0,0,0,0,0
Kec. Nuhon Kab. Banggai,2,2,0,0,0,4
Kec. Luwuk Timur Kab. Banggai,1,1,0,0,0,2
Kec. Masama Kab. Banggai,3,1,0,0,0,4
Kec. Moilong Kab. Banggai,0,0,0,0,0,0
Kec. Batui Selatan Kab. Banggai,0,0,0,0,0,0
Kec. Mantoh Kab. Banggai,0,0,0,0,0,0
Kec. Balantak Selatan Kab. Banggai,0,0,0,0,0,0
Kec. Simpang Raya Kab. Banggai,0,1,0,0,0,1
Kec. Biau Kab. Buol,2,0,0,0,0,2
Kec. Momunu Kab. Buol,0,0,0,0,0,0
Kec. Bokat Kab. Buol,0,0,0,0,0,0
Kec. Bunobogu Kab. Buol,0,0,0,0,0,0
Kec. Paleleh Kab. Buol,2,0,0,0,0,2
Kec. Bukal Kab. Buol,1,1,0,0,0,2
Kec. Karamat Kab. Buol,0,0,0,0,0,0
Kec. Paleleh Barat Kab. Buol,0,0,0,0,0,0
Kec. Lakea Kab. Buol,0,0,0,0,0,0
Kec. Dampal Selatan Kab. Tolitoli,1,1,0,0,0,2
Kec. Dampal Utara Kab. Tolitoli,0,0,0,0,0,0
Kec. Dondo Kab. Tolitoli,0,0,0,0,0,0
Kec. Baolan Kab. Tolitoli,5,3,0,0,0,8
Kec. Tolitoli Utara Kab. Tolitoli,0,0,0,0,0,0
Kec. Ogodeide Kab. Tolitoli,0,0,0,0,0,0
Kec. Basidondo Kab. Tolitoli,0,0,0,0,0,0
Kec. Lampasio Kab. Tolitoli,2,0,0,0,0,2
Kec. Menui Kepulauan Kab. Morowali,2,0,0,0,0,2
Kec. Bungku Selatan Kab. Morowali,0,0,0,0,0,0
Kec. Bungku Tengah Kab. Morowali,2,0,0,0,0,2
Kec. Bahodopi Kab. Morowali,0,0,0,0,0,0
Kec. Witaponda Kab. Morowali,2,0,0,0,0,2
Kec. Bumi Raya Kab. Morowali,0,0,0,0,0,0
Kec. Bungku Timur Kab. Morowali,1,1,0,0,0,2
Kec. Bungku Pesisir Kab. Morowali,0,0,0,0,0,0
Kec. Banawa Kab. Donggala,2,0,0,0,0,2
Kec. Sindue Kab. Donggala,2,0,0,0,0,2
Kec. Sirenja Kab. Donggala,0,0,0,0,0,0
Kec. Balaesang Kab. Donggala,6,0,0,0,0,6
Kec. Dampelas Kab. Donggala,1,1,0,0,0,2
Kec. Sojol Kab. Donggala,0,0,0,0,0,0
Kec. Rio Pakava Kab. Donggala,0,0,0,0,0,0
Kec. Banawa Selatan Kab. Donggala,0,0,0,0,0,0
Kec. Tanantovea Kab. Donggala,0,0,0,0,0,0
Kec. Banawa Tengah Kab. Donggala,0,0,0,0,0,0
Kec. Sindue Tombusabora Kab. Donggala,0,0,0,0,0,0
Kec. Sindue Tobata Kab. Donggala,0,0,0,0,0,0
Kec. Balaesang Tanjung Kab. Donggala,1,0,0,0,0,1
Kec. Pamona Selatan Kab. Poso,0,0,0,0,0,0
Kec. Lore Selatan Kab. Poso,0,0,0,0,0,0
Kec. Pamona Utara Kab. Poso,4,0,0,0,0,4
Kec. Lore Utara Kab. Poso,0,0,0,0,0,0
Kec. Lage Kab. Poso,0,0,0,0,0,0
Kec. Poso Kota Kab. Poso,5,1,0,0,0,6
Kec. Pamona Timur Kab. Poso,0,0,0,0,0,0
Kec. Pamona Barat Kab. Poso,2,0,0,0,0,2
Kec. Poso Pesisir Selatan Kab. Poso,0,0,0,0,0,0
Kec. Poso Pesisir Utara Kab. Poso,0,0,0,0,0,0
Kec. Poso Kota Utara Kab. Poso,4,0,0,0,0,4
Kec. Poso Kota Selatan Kab. Poso,2,0,0,0,0,2
Kec. Pamona Puselemba Kab. Poso,2,2,0,0,0,4
KEC. BOKAN KEPULAUAN Kab. Banggai Laut,2,0,0,0,0,2
KEC. BANGKURUNG Kab. Banggai Laut,0,0,0,0,0,0
KEC. LABOBO  Kab. Banggai Laut,2,0,0,0,0,2
KEC. BANGGAI TENGAH Kab. Banggai Laut,0,0,0,0,0,0
Kec. Banggai Kab. Banggai Laut,1,1,0,0,0,2
Kec. Bungku Utara Kab. Morowali Utara,0,0,0,0,0,0
Kec. Lembo Kab. Morowali Utara,0,0,0,0,0,0
Kec. Mamosalato Kab. Morowali Utara,0,0,0,0,0,0
Kec. Mori Atas Kab. Morowali Utara,0,0,0,0,0,0
Kec. Petasia Kab. Morowali Utara,2,0,0,0,0,2
Kec. Petasia Timur Kab. Morowali Utara,0,0,0,0,0,0
Kec. Soyo Jaya Kab. Morowali Utara,0,2,0,0,0,2
Kec. Palu Barat Kota Palu,4,0,0,0,0,4
Kec. Palu Selatan Kota Palu,4,0,0,0,0,4
Kec. Palu Timur Kota Palu,5,1,0,0,0,6
Kec. Palu Utara Kota Palu,0,0,0,0,0,0
Kec. Ulujadi Kota Palu,1,1,0,0,0,2
Kec. Tatanga Kota Palu,2,4,0,0,0,6
Kec. Tawaeli Kota Palu,2,0,0,0,0,2
Kec. Mantikulore Kota Palu,10,0,0,0,0,10
Kec. Sausu Kab. Parigi Moutong,1,1,0,0,0,2
Kec. Parigi Kab. Parigi Moutong,2,2,0,0,0,4
Kec. Ampibabo Kab. Parigi Moutong,2,0,0,0,0,2
Kec. Tinombo Kab. Parigi Moutong,2,0,0,0,0,2
Kec. Tomini Kab. Parigi Moutong,0,0,0,0,0,0
Kec. Moutong Kab. Parigi Moutong,0,0,0,0,0,0
Kec. Bolano Lambunu Kab. Parigi Moutong,0,0,0,0,0,0
Kec. Kasimbar Kab. Parigi Moutong,1,1,0,0,0,2
Kec. Torue Kab. Parigi Moutong,2,0,0,0,0,2
Kec. Tinombo Selatan Kab. Parigi Moutong,1,1,0,0,0,2
Kec. Parigi Selatan Kab. Parigi Moutong,0,0,0,0,0,0
Kec. Mepanga Kab. Parigi Moutong,2,0,0,0,0,2
Kec. Parigi Barat Kab. Parigi Moutong,0,0,0,0,0,0
Kec. Parigi Utara Kab. Parigi Moutong,0,0,0,0,0,0
Kec. Palasa Kab. Parigi Moutong,0,0,0,0,0,0
Kec. Taopa Kab. Parigi Moutong,0,0,0,0,0,0
Kec. Parigi Tengah Kab. Parigi Moutong,2,0,0,0,0,2
Kec. Balinggi Kab. Parigi Moutong,0,0,0,0,0,0
Kec. Ongka Malino Kab. Parigi Moutong,0,0,0,0,0,0
Kec. Bolano Kab. Parigi Moutong,3,0,1,0,0,4
Kec. Sidoan Kab. Parigi Moutong,0,0,0,0,0,0
Kec. Burau Kab. Luwu Timur,0,2,0,0,0,2
Kec. Tomoni Kab. Luwu Timur,4,0,0,0,0,4
Kec. Wotu Kab. Luwu Timur,4,0,0,0,0,4
Kec. Malili Kab. Luwu Timur,3,1,0,0,0,4
Kec. Nuha Kab. Luwu Timur,3,1,0,0,0,4
Kec. Mangkutana Kab. Luwu Timur,2,2,0,0,0,4
Kec. Towuti Kab. Luwu Timur,3,1,0,0,0,4
Kec. Angkona Kab. Luwu Timur,2,0,0,0,0,2
Kec. Tomoni Timur Kab. Luwu Timur,0,0,0,0,0,0
Kec. Kalaena Kab. Luwu Timur,0,0,0,0,0,0
Kec. Wasuponda Kab. Luwu Timur,2,0,0,0,0,2
Kec. Kapala Pitu Kab. Toraja Utara,2,0,0,0,0,2
Kec. Kesu Kab. Toraja Utara,0,0,0,0,0,0
Kec. Nanggala Kab. Toraja Utara,0,0,0,0,0,0
Kec. Rantepao Kab. Toraja Utara,8,0,0,0,0,8
Kec. Rindingallo Kab. Toraja Utara,2,0,0,0,0,2
Kec. Sa`dan  Kab. Toraja Utara,0,0,0,0,0,0
Kec. Sesean Kab. Toraja Utara,2,0,0,0,0,2
Kec. Tallunglipu Kab. Toraja Utara,1,1,0,0,0,2
Kec. Tikala Kab. Toraja Utara,2,0,0,0,0,2
Kec. Tondon  Kab. Toraja Utara,0,0,0,0,0,0
Kec. Buntu Pepasan Kab. Toraja Utara,0,0,0,0,0,0
Kec. Liukang Tangaya Kab. Pangkajene Kepulauan,0,0,0,0,0,0
Kec. Liukang Kalmas Kab. Pangkajene Kepulauan,0,0,0,0,0,0
Kec. Liukang Tapabbiring Kab. Pangkajene Kepulauan,0,0,0,0,0,0
Kec. Pangkajene Kab. Pangkajene Kepulauan,6,4,0,0,0,10
Kec. Balocci Kab. Pangkajene Kepulauan,0,2,0,0,0,2
Kec. Bungoro Kab. Pangkajene Kepulauan,6,0,0,0,0,6
Kec. Labakkang Kab. Pangkajene Kepulauan,1,1,0,0,0,2
Kec. Ma`rang Kab. Pangkajene Kepulauan,2,0,0,0,0,2
Kec. Segeri Kab. Pangkajene Kepulauan,1,1,0,0,0,2
Kec. Minasatene Kab. Pangkajene Kepulauan,2,0,0,0,0,2
Kec. Tondong Tallasa Kab. Pangkajene Kepulauan,0,0,0,0,0,0
Kec. Mandalle Kab. Pangkajene Kepulauan,1,1,0,0,0,2
Kec. Liukang Tupabbiring Utara Kab. Pangkajene Kepulauan,0,0,0,0,0,0
Kec. Bontonompo Kab. Gowa,2,0,0,0,0,2
Kec. Bajeng Kab. Gowa,0,0,0,0,0,0
Kec. Pallangga Kab. Gowa,2,0,0,0,0,2
Kec. Somba Opu Kab. Gowa,12,2,0,0,0,14
Kec. Bontomarannu Kab. Gowa,0,0,0,0,0,0
Kec. Parang Loe Kab. Gowa,1,1,0,0,0,2
Kec. Tinggi Moncong Kab. Gowa,4,0,0,0,0,4
Kec. Bungaya Kab. Gowa,2,0,0,0,0,2
Kec. Tompobulu Kab. Gowa,0,0,0,0,0,0
Kec. Barombong Kab. Gowa,0,0,0,0,0,0
Kec. Biring Bulu Kab. Gowa,0,0,0,0,0,0
Kec. Tombolo Pao Kab. Gowa,2,0,0,0,0,2
Kec. Manuju Kab. Gowa,1,1,0,0,0,2
Kec. Bontolempangan Kab. Gowa,0,0,0,0,0,0
Kec. Pattallassang Kab. Gowa,2,0,0,0,0,2
Kec. Bontonompo Selatan Kab. Gowa,0,0,0,0,0,0
Kec. Parigi Kab. Gowa,0,0,0,0,0,0
Kec. Bajeng Barat Kab. Gowa,0,0,0,0,0,0
Kec. Mangarabombang Kab. Takalar,0,0,0,0,0,0
Kec. Mappakasunggu Kab. Takalar,0,0,0,0,0,0
Kec. Polombangkeng Selatan Kab. Takalar,2,2,0,0,0,4
Kec. Polombangkeng Utara Kab. Takalar,8,2,0,0,0,10
Kec. Galesong Selatan Kab. Takalar,0,0,0,0,0,0
Kec. Galesong Utara Kab. Takalar,2,0,0,0,0,2
Kec. Pattallassang Kab. Takalar,6,0,0,0,0,6
Kec. Galesong Kab. Takalar,0,0,0,0,0,0
Kec. Bangkala Kab. Jeneponto,0,0,0,0,0,0
Kec. Tamalatea Kab. Jeneponto,5,1,0,0,0,6
Kec. Binamu Kab. Jeneponto,5,3,0,0,0,8
Kec. Batang Kab. Jeneponto,1,1,0,0,0,2
Kec. Kelara Kab. Jeneponto,1,1,0,0,0,2
Kec. Bangkala Barat Kab. Jeneponto,2,0,0,0,0,2
Kec. Bontoramba Kab. Jeneponto,2,0,0,0,0,2
Kec. Turatea Kab. Jeneponto,0,2,0,0,0,2
Kec. Arungkeke Kab. Jeneponto,0,0,0,0,0,0
Kec. Rumbia Kab. Jeneponto,0,0,0,0,0,0
Kec. Panca Lautang Kab. Sidenreng Rappang,0,0,0,0,0,0
Kec. Tellulimpoe Kab. Sidenreng Rappang,1,1,0,0,0,2
Kec. Watangpulu Kab. Sidenreng Rappang,5,1,0,0,0,6
Kec. Baranti Kab. Sidenreng Rappang,1,1,0,0,0,2
Kec. Panca Rijang Kab. Sidenreng Rappang,5,1,0,0,0,6
Kec. Maritengae Kab. Sidenreng Rappang,9,1,0,0,0,10
Kec. Pitu Riawa Kab. Sidenreng Rappang,0,2,0,0,0,2
Kec. Duapitue Kab. Sidenreng Rappang,0,0,0,0,0,0
Kec. Pitu Riase Kab. Sidenreng Rappang,0,0,0,0,0,0
Kec. Maiwa Kab. Enrekang,5,1,0,0,0,6
Kec. Enrekang Kab. Enrekang,4,0,0,0,0,4
Kec. Baraka Kab. Enrekang,1,1,0,0,0,2
Kec. Anggeraja Kab. Enrekang,0,0,0,0,0,0
Kec. Alla Kab. Enrekang,3,1,0,0,0,4
Kec. Bungin Kab. Enrekang,0,0,0,0,0,0
Kec. Cendana Kab. Enrekang,2,0,0,0,0,2
Kec. Curio Kab. Enrekang,0,0,0,0,0,0
Kec. Malua Kab. Enrekang,0,0,0,0,0,0
Kec. Buntu Batu Kab. Enrekang,0,2,0,0,0,2
Kec. Masalle Kab. Enrekang,0,0,0,0,0,0
Kec. Larompong Kab. Luwu,2,0,0,0,0,2
Kec. Belopa Kab. Luwu,2,0,0,0,0,2
Kec. Bajo Kab. Luwu,1,1,0,0,0,2
Kec. Bassesangtempe Kab. Luwu,0,0,0,0,0,0
Kec. Bua Ponrang (Bupon) Kab. Luwu,0,0,0,0,0,0
Kec. Bua Kab. Luwu,0,0,0,0,0,0
Kec. Walenrang Kab. Luwu,3,1,0,0,0,4
Kec. Lamasi Kab. Luwu,0,0,0,0,0,0
Kec. Latimojong Kab. Luwu,0,0,0,0,0,0
Kec. Larompong Selatan Kab. Luwu,1,1,0,0,0,2
Kec. Kamanre Kab. Luwu,4,0,0,0,0,4
Kec. Walenrang Utara Kab. Luwu,0,0,0,0,0,0
Kec. Lamasi Timur Kab. Luwu,1,1,0,0,0,2
Kec. Suli Barat Kab. Luwu,1,1,0,0,0,2
Kec. Bajo Barat Kab. Luwu,0,0,0,0,0,0
Kec. Ponrang Selatan Kab. Luwu,0,0,0,0,0,0
Kec. Ponrang Kab. Luwu,1,1,0,0,0,2
Kec. Belopa Utara Kab. Luwu,2,0,0,0,0,2
Kec. Gantarang Kab. Bulukumba,0,0,0,0,0,0
Kec. Ujung Bulu Kab. Bulukumba,1,1,0,0,0,2
Kec. Bontobahari Kab. Bulukumba,0,0,0,0,0,0
Kec. Bontotiro Kab. Bulukumba,1,1,0,0,0,2
Kec. Herlang Kab. Bulukumba,0,2,0,0,0,2
Kec. Kajang Kab. Bulukumba,0,2,0,0,0,2
Kec. Bulukumpa Kab. Bulukumba,0,0,0,0,0,0
Kec. Rilau Ale Kab. Bulukumba,2,0,0,0,0,2
Kec. Kindang Kab. Bulukumba,1,1,0,0,0,2
Kec. Ujung Loe Kab. Bulukumba,1,1,0,0,0,2
Kec. Sinjai Barat Kab. Sinjai,1,1,0,0,0,2
Kec. Sinjai Borong Kab. Sinjai,4,0,0,0,0,4
Kec. Sinjai Selatan Kab. Sinjai,3,1,0,0,0,4
Kec. Tellu Limpoe Kab. Sinjai,0,0,0,0,0,0
Kec. Sinjai Timur Kab. Sinjai,2,0,0,0,0,2
Kec. Sinjai Tengah Kab. Sinjai,2,0,0,0,0,2
Kec. Sinjai Utara Kab. Sinjai,4,0,0,0,0,4
Kec. Bulupoddo Kab. Sinjai,0,0,0,0,0,0
Kec. Pasimarannu Kab. Kepulauan Selayar,0,2,0,0,0,2
Kec. Bontosikuyu Kab. Kepulauan Selayar,1,1,0,0,0,2
Kec. Bontoharu Kab. Kepulauan Selayar,2,2,0,0,0,4
Kec. Bontomatene Kab. Kepulauan Selayar,1,1,0,0,0,2
Kec. Bontomanai Kab. Kepulauan Selayar,2,0,0,0,0,2
Kec. Benteng Kab. Kepulauan Selayar,2,0,0,0,0,2
Kec. Taka Bonerate Kab. Kepulauan Selayar,0,0,0,0,0,0
Kec. Pasimasunggu Timur Kab. Kepulauan Selayar,0,0,0,0,0,0
Kec. Buki Kab. Kepulauan Selayar,0,0,0,0,0,0
Kec. Suppa Kab. Pinrang,0,2,0,0,0,2
Kec. Mattiro Sompe Kab. Pinrang,1,1,0,0,0,2
Kec. Mattiro Bulu Kab. Pinrang,2,0,0,0,0,2
Kec. Watang Sawitto Kab. Pinrang,5,3,0,0,0,8
Kec. Patampanua Kab. Pinrang,2,0,0,0,0,2
Kec. Cempa Kab. Pinrang,0,0,0,0,0,0
Kec. Duampanua Kab. Pinrang,1,1,0,0,0,2
Kec. Lembang Kab. Pinrang,1,1,0,0,0,2
Kec. Lanrisang Kab. Pinrang,0,1,0,0,0,1
Kec. Tiroang Kab. Pinrang,0,2,0,0,0,2
Kec. Paleteang Kab. Pinrang,2,0,0,0,0,2
Kec. Tanete Riaja Kab. Barru,1,1,0,0,0,2
Kec. Tanete Rilau Kab. Barru,0,2,0,0,0,2
Kec. Barru Kab. Barru,5,1,0,0,0,6
Kec. Soppeng Riaja Kab. Barru,1,1,0,0,0,2
Kec. Mallusetasi Kab. Barru,1,1,0,0,0,2
Kec. Balusu Kab. Barru,1,1,0,0,0,2
Kec. Bontocani Kab. Bone,1,1,0,0,0,2
Kec. Kahu Kab. Bone,6,2,0,0,0,8
Kec. Kajuara Kab. Bone,2,0,0,0,0,2
Kec. Salomekko Kab. Bone,1,1,0,0,0,2
Kec. Tonra Kab. Bone,0,0,0,0,0,0
Kec. Patimpeng Kab. Bone,0,0,0,0,0,0
Kec. Libureng Kab. Bone,3,1,0,0,0,4
Kec. Mare Kab. Bone,2,0,0,0,0,2
Kec. Sibulue Kab. Bone,2,0,0,0,0,2
Kec. Cina Kab. Bone,4,0,0,0,0,4
Kec. Ponre Kab. Bone,0,0,0,0,0,0
Kec. Lappariaja Kab. Bone,2,0,0,0,0,2
Kec. Lamuru Kab. Bone,1,1,0,0,0,2
Kec. Bengo Kab. Bone,0,0,0,0,0,0
Kec. Ulaweng Kab. Bone,1,1,0,0,0,2
Kec. Palakka Kab. Bone,2,0,0,0,0,2
Kec. Awangpone Kab. Bone,2,0,0,0,0,2
Kec. Tellu Siattinge Kab. Bone,2,0,0,0,0,2
Kec. Amali Kab. Bone,0,0,0,0,0,0
Kec. Ajangale Kab. Bone,2,0,0,0,0,2
Kec. Dua Boccoe Kab. Bone,0,0,0,0,0,0
Kec. Cenrana Kab. Bone,4,0,0,0,0,4
Kec. Tanete Riattang Barat Kab. Bone,9,3,0,0,0,12
Kec. Tanete Riattang Kab. Bone,1,1,0,0,0,2
Kec. Tanete Riattang Timur Kab. Bone,3,1,0,0,0,4
Kec. Tellu Limpoe Kab. Bone,0,0,0,0,0,0
Kec. Sabbangparu Kab. Wajo,0,0,0,0,0,0
Kec. Tempe Kab. Wajo,3,3,0,0,0,6
Kec. Pammana Kab. Wajo,3,1,0,0,0,4
Kec. Bola Kab. Wajo,2,0,0,0,0,2
Kec. Takkalala Kab. Wajo,1,1,0,0,0,2
Kec. Sajo Anging Kab. Wajo,1,1,0,0,0,2
Kec. Majauleng Kab. Wajo,1,1,0,0,0,2
Kec. Belawa Kab. Wajo,0,0,0,0,0,0
Kec. Maniang Pajo Kab. Wajo,1,1,0,0,0,2
Kec. Keera Kab. Wajo,2,0,0,0,0,2
Kec. Pitumpanua Kab. Wajo,0,0,0,0,0,0
Kec. Penrang Kab. Wajo,1,1,0,0,0,2
Kec. Marioriwawo Kab. Soppeng,2,0,0,0,0,2
Kec. Lalabata Kab. Soppeng,10,0,0,0,0,10
Kec. Liliriaja Kab. Soppeng,1,1,0,0,0,2
Kec. Lili Rilau Kab. Soppeng,4,0,0,0,0,4
Kec. Donri-Donri Kab. Soppeng,1,1,0,0,0,2
Kec. Mario Riawa Kab. Soppeng,2,2,0,0,0,4
Kec. Bissappu Kab. Bantaeng,0,0,0,0,0,0
Kec. Bantaeng Kab. Bantaeng,1,1,0,0,0,2
Kec. Tompobulu Kab. Bantaeng,0,0,0,0,0,0
Kec. Ulu Ere Kab. Bantaeng,0,0,0,0,0,0
Kec. Ere Merasa Kab. Bantaeng,2,0,0,0,0,2
Kec. Pa`jukukang Kab. Bantaeng,1,1,0,0,0,2
Kec. Gantarang Keke Kab. Bantaeng,1,1,0,0,0,2
Kec. Mandai Kab. Maros,6,2,0,0,0,8
Kec. Maros Baru Kab. Maros,2,0,0,0,0,2
Kec. Maros Utara / Bontoa Kab. Maros,0,0,0,0,0,0
Kec. Bantimurung Kab. Maros,5,1,0,0,0,6
Kec. Tanralili Kab. Maros,3,1,0,0,0,4
Kec. Camba Kab. Maros,6,0,0,0,0,6
Kec. Mallawa Kab. Maros,2,0,0,0,0,2
Kec. Moncongloe Kab. Maros,2,0,0,0,0,2
Kec. Turikale Kab. Maros,3,3,0,0,0,6
Kec. Marusu Kab. Maros,0,0,0,0,0,0
Kec. Lau Kab. Maros,1,3,0,0,0,4
Kec. Simbang Kab. Maros,2,0,0,0,0,2
Kec. Tompobulu Kab. Maros,2,0,0,0,0,2
Kec. Cenrana Kab. Maros,2,0,0,0,0,2
Kec. Mariso Kota Makassar,7,1,0,0,0,8
Kec. Mamajang Kota Makassar,11,5,0,0,0,16
Kec. Tamalate Kota Makassar,8,4,0,0,0,12
Kec. Makasar Kota Makassar,8,2,0,0,0,10
Kec. Ujung Pandang Kota Makassar,11,3,0,0,0,14
Kec. Wajo Kota Makassar,4,0,0,0,0,4
Kec. Bontoala Kota Makassar,6,2,0,0,0,8
Kec. Ujung Tanah Kota Makassar,5,1,0,0,0,6
Kec. Tallo Kota Makassar,4,2,0,0,0,6
Kec. Panakukkang Kota Makassar,8,4,0,0,0,12
Kec. Biringkanaya Kota Makassar,13,3,0,0,0,16
Kec. Tamalanrea Kota Makassar,6,2,0,0,0,8
Kec. Rappocini Kota Makassar,6,4,0,0,0,10
Kec. Manggala Kota Makassar,12,3,0,0,0,15
Kec. Ujung Kota Parepare,3,3,0,0,0,6
Kec. Soreang Kota Parepare,1,1,0,0,0,2
Kec. Bacukiki Barat Kota Parepare,5,1,0,0,0,6
Kec. Wara Kota Palopo,4,0,0,0,0,4
Kec. Wara Utara Kota Palopo,6,0,0,0,0,6
Kec. Wara Selatan Kota Palopo,2,0,0,0,0,2
Kec. Wara Barat Kota Palopo,0,0,0,0,0,0
Kec. Sendana Kota Palopo,0,0,0,0,0,0
Kec. Bara Kota Palopo,6,0,0,0,0,6
Kec. Bonggakaradeng Kab. Tana Toraja,0,2,0,0,0,2
Kec. Mengkendek Kab. Tana Toraja,3,1,0,0,0,4
Kec. Sangalla Kab. Tana Toraja,2,0,0,0,0,2
Kec. Makale Kab. Tana Toraja,5,1,0,0,0,6
Kec. Saluputti Kab. Tana Toraja,0,0,0,0,0,0
Kec. Simbuang Kab. Tana Toraja,0,0,0,0,0,0
Kec. Rantetayo Kab. Tana Toraja,0,0,0,0,0,0
Kec. Bittuang Kab. Tana Toraja,0,0,0,0,0,0
Kec. Mappak Kab. Tana Toraja,0,0,0,0,0,0
Kec. Gandangbatu Sillanan Kab. Tana Toraja,2,2,0,0,0,4
Kec. Masanda Kab. Tana Toraja,1,1,0,0,0,2
Kec. Sabbang Kab. Luwu Utara,2,0,0,0,0,2
Kec. Baebunta Kab. Luwu Utara,0,2,0,0,0,2
Kec. Malangke Kab. Luwu Utara,2,2,0,0,0,4
Kec. Sukamaju Kab. Luwu Utara,0,0,0,0,0,0
Kec. Bone-Bone Kab. Luwu Utara,0,2,0,0,0,2
Kec. Masamba Kab. Luwu Utara,1,1,0,0,0,2
Kec. Rongkong Kab. Luwu Utara,0,0,0,0,0,0
Kec. Mappedeceng Kab. Luwu Utara,0,2,0,0,0,2
Kec. Seko Kab. Luwu Utara,0,0,0,0,0,0
Kec. Rampi Kab. Luwu Utara,0,0,0,0,0,0
Kec. Malangke Barat Kab. Luwu Utara,0,0,0,0,0,0
Kec. Tana Lili Kab. Luwu Utara,0,0,0,0,0,0
Kec. Baebunta Selatan Kab. Luwu Utara,2,0,0,0,0,2
Kec. Tinanggea Kab. Konawe Selatan,2,2,0,0,0,4
Kec. Palangga Kab. Konawe Selatan,2,0,0,0,0,2
Kec. Konda Kab. Konawe Selatan,2,0,0,0,0,2
Kec. Lainea Kab. Konawe Selatan,0,0,0,0,0,0
Kec. Moramo Kab. Konawe Selatan,3,1,0,0,0,4
Kec. Ranomeeto Kab. Konawe Selatan,0,0,0,0,0,0
Kec. Landono Kab. Konawe Selatan,0,0,0,0,0,0
Kec. Kolono Kab. Konawe Selatan,2,0,0,0,0,2
Kec. Andolo Kab. Konawe Selatan,0,0,0,0,0,0
Kec. Laonti Kab. Konawe Selatan,0,0,0,0,0,0
Kec. Angata Kab. Konawe Selatan,0,0,0,0,0,0
Kec. Lalembuu Kab. Konawe Selatan,0,1,0,0,0,1
Kec. Buke Kab. Konawe Selatan,0,0,0,0,0,0
Kec. Palangga Selatan Kab. Konawe Selatan,0,0,0,0,0,0
Kec. Baito Kab. Konawe Selatan,0,0,0,0,0,0
Kec. Laeya Kab. Konawe Selatan,8,0,0,0,0,8
Kec. Moramo Utara Kab. Konawe Selatan,0,0,0,0,0,0
Kec. Wolasi Kab. Konawe Selatan,0,0,0,0,0,0
Kec. Ranomeeto Barat Kab. Konawe Selatan,0,0,0,0,0,0
Kec. Basala Kab. Konawe Selatan,0,0,0,0,0,0
Kec. Langgikima Kab. Konawe Utara,2,0,0,0,0,2
Kec. Lembo Kab. Konawe Utara,0,0,0,0,0,0
Kec. Asera Kab. Konawe Utara,0,2,0,0,0,2
Kec. Wiwirano Kab. Konawe Utara,0,0,0,0,0,0
Kec. Lasolo Kab. Konawe Utara,0,2,0,0,0,2
Kec. Sawa Kab. Konawe Utara,4,0,0,0,0,4
Kec. Oheo Kab. Konawe Utara,0,0,0,0,0,0
Kec. Motui Kab. Konawe Utara,0,0,0,0,0,0
Kec. Landawe Kab. Konawe Utara,0,0,0,0,0,0
Kec. Lasolo Kepulauan Kab. Konawe Utara,0,0,0,0,0,0
Kec. Kulisusu Kab. Buton Utara,1,1,0,0,0,2
Kec. Kulisusu Barat Kab. Buton Utara,0,0,0,0,0,0
Kec. Kulisusu Utara Kab. Buton Utara,0,0,0,0,0,0
Kec. Kambowa Kab. Buton Utara,0,0,0,0,0,0
Kec. Bonegunu Kab. Buton Utara,0,0,0,0,0,0
Kec. Wakorumba Utara Kab. Buton Utara,0,0,0,0,0,0
KEC. LADONGI Kab. Kolaka Timur,3,1,0,0,0,4
KEC. POLI-POLIA Kab. Kolaka Timur,0,0,0,0,0,0
KEC. LAMBANDIA Kab. Kolaka Timur,2,0,0,0,0,2
Kec. Lalolae Kab. Kolaka Timur,0,0,0,0,0,0
KEC. MOWEWE Kab. Kolaka Timur,0,2,0,0,0,2
KEC. ULUIWOI Kab. Kolaka Timur,0,0,0,0,0,0
KEC. TINONDO Kab. Kolaka Timur,0,0,0,0,0,0
KEC. TIRAWUTA Kab. Kolaka Timur,3,1,0,0,0,4
Kec. Ueesi Kab. Kolaka Timur,0,0,0,0,0,0
Kec. Aere Kab. Kolaka Timur,0,0,0,0,0,0
Kec. Dangia Kab. Kolaka Timur,0,2,0,0,0,2
Kec. Tongkuno Kab. Muna,4,0,0,0,0,4
Kec. Parigi Kab. Muna,2,0,0,0,0,2
Kec. Kabawo Kab. Muna,1,1,0,0,0,2
Kec. Katobu Kab. Muna,3,2,0,0,0,5
Kec. Napabalano Kab. Muna,0,2,0,0,0,2
Kec. Wakorumba Selatan Kab. Muna,0,0,0,0,0,0
Kec. Lohia Kab. Muna,2,0,0,0,0,2
Kec. Kontunaga Kab. Muna,2,0,0,0,0,2
Kec. Kabangka Kab. Muna,1,1,0,0,0,2
Kec. Maligano Kab. Muna,0,0,0,0,0,0
Kec. Watopute Kab. Muna,0,0,0,0,0,0
Kec. Batalaiworu Kab. Muna,7,1,0,0,0,8
Kec. Duruka Kab. Muna,0,0,0,0,0,0
Kec. Lasalepa Kab. Muna,0,0,0,0,0,0
Kec. Pasir Putih Kab. Muna,0,0,0,0,0,0
Kec. Bone Kab. Muna,2,2,0,0,0,4
Kec. Kontu Kowuna Kab. Muna,2,0,0,0,0,2
Kec. Marobo Kab. Muna,0,0,0,0,0,0
Kec. Tongkuno Selatan Kab. Muna,1,1,0,0,0,2
Kec. Batukara Kab. Muna,0,2,0,0,0,2
Kec. Towea Kab. Muna,0,0,0,0,0,0
Kec. Lasalimu Kab. Buton,2,0,0,0,0,2
Kec. Pasar Wajo Kab. Buton,5,1,0,0,0,6
Kec. Kapontori Kab. Buton,0,0,0,0,0,0
Kec. Lasalimu Selatan Kab. Buton,2,0,0,0,0,2
Kec. Siontapia Kab. Buton,0,0,0,0,0,0
Kec. Wolowa Kab. Buton,0,0,0,0,0,0
Kec. Wabula Kab. Buton,2,0,0,0,0,2
Kec. Betoambari Kota Baubau,2,0,0,0,0,2
Kec. Wolio Kota Baubau,2,2,0,0,0,4
Kec. Sorawolio Kota Baubau,0,2,0,0,0,2
Kec. Bungi Kota Baubau,0,2,0,0,0,2
Kec. Murhum Kota Baubau,2,4,0,0,0,6
Kec. Lea-Lea Kota Baubau,2,0,0,0,0,2
Kec. Wawonii Barat Kab. Konawe Kepulauan,0,0,0,0,0,0
Kec. Wawonii Utara Kab. Konawe Kepulauan,0,0,0,0,0,0
Kec. Wawonii Timur Laut Kab. Konawe Kepulauan,0,0,0,0,0,0
Kec. Wawonii Timur Kab. Konawe Kepulauan,0,0,0,0,0,0
Kec. Wawonii Tenggara Kab. Konawe Kepulauan,0,0,0,0,0,0
Kec. Wawonii Tengah Kab. Konawe Kepulauan,2,0,0,0,0,2
Kec. Sawerigadi Kab. Muna Barat,0,0,0,0,0,0
Kec. Barangka Kab. Muna Barat,0,2,0,0,0,2
Kec. Lawa Kab. Muna Barat,1,1,0,0,0,2
Kec. Wadaga Kab. Muna Barat,0,0,0,0,0,0
Kec. Maginti Kab. Muna Barat,2,0,0,0,0,2
Kec. Tiworo Tengah Kab. Muna Barat,0,0,0,0,0,0
Kec. Tiworo Kepulauan Kab. Muna Barat,2,0,0,0,0,2
Kec. Napano Kusambi Kab. Muna Barat,0,0,0,0,0,0
Kec. Kusambi Kab. Muna Barat,0,2,0,0,0,2
Kec. Batauga Kab. Buton Selatan,2,0,0,0,0,2
Kec. Sampolawa Kab. Buton Selatan,6,0,0,0,0,6
Kec. Lapandewa Kab. Buton Selatan,2,0,0,0,0,2
Kec. Batu Atas Kab. Buton Selatan,0,0,0,0,0,0
Kec. Siompu Barat Kab. Buton Selatan,1,1,0,0,0,2
Kec. Siompu Kab. Buton Selatan,0,0,0,0,0,0
Kec. Kadatua Kab. Buton Selatan,0,0,0,0,0,0
Kec. Lakudo Kab. Buton Tengah,4,1,0,0,0,5
Kec. Mawasangka Timur Kab. Buton Tengah,2,0,0,0,0,2
Kec. Mawasangka Tengah Kab. Buton Tengah,3,1,0,0,0,4
Kec. Mawasangka Kab. Buton Tengah,5,1,0,0,0,6
Kec.Talaga Raya Kab. Buton Tengah,0,0,0,0,0,0
Kec. Gu Kab. Buton Tengah,0,2,0,0,0,2
Kec. Sangia Wambulu Kab. Buton Tengah,0,0,0,0,0,0
Kec. Mandonga Kota Kendari,1,3,0,0,0,4
Kec. Poasia Kota Kendari,0,4,0,0,0,4
Kec. Kendari Kota Kendari,1,3,0,0,0,4
Kec. Baruga Kota Kendari,4,2,0,0,0,6
Kec. Kendari Barat Kota Kendari,2,4,0,0,0,6
Kec. Abeli Kota Kendari,0,0,0,0,0,0
Kec. Puuwatu Kota Kendari,2,0,0,0,0,2
Kec. Kadia Kota Kendari,3,3,0,0,0,6
Kec. Wua-Wua Kota Kendari,2,0,0,0,0,2
Kec. Kambu Kota Kendari,4,0,0,0,0,4
Kec. Soropia Kab. Konawe,1,1,0,0,0,2
Kec. Sampara Kab. Konawe,2,0,0,0,0,2
Kec. Lambuya Kab. Konawe,1,1,0,0,0,2
Kec. Pondidaha Kab. Konawe,2,0,0,0,0,2
Kec. Wawotobi Kab. Konawe,1,1,0,0,0,2
Kec. Unaaha Kab. Konawe,6,2,0,0,0,8
Kec. Abuki Kab. Konawe,0,0,0,0,0,0
Kec. Bondoala Kab. Konawe,0,0,0,0,0,0
Kec. Uepai Kab. Konawe,0,0,0,0,0,0
Kec. Wonggeduku Kab. Konawe,0,0,0,0,0,0
Kec. Tongauna Kab. Konawe,2,0,0,0,0,2
Kec. Besulutu Kab. Konawe,0,0,0,0,0,0
Kec. Puriala Kab. Konawe,0,1,0,0,0,1
Kec. Meluhu Kab. Konawe,0,0,0,0,0,0
Kec. Amonggedo Kab. Konawe,0,0,0,0,0,0
Kec. Routa Kab. Konawe,0,0,0,0,0,0
Kec. Anggaberi Kab. Konawe,0,0,0,0,0,0
Kec. Kapoiala Kab. Konawe,0,0,0,0,0,0
Kec. Konawe Kab. Konawe,0,0,0,0,0,0
Kec. Asinua Kab. Konawe,0,0,0,0,0,0
Kec. Onembute Kab. Konawe,0,0,0,0,0,0
Kec. Morosi Kab. Konawe,0,0,0,0,0,0
Kec. Wonggeduku Barat Kab. Konawe,2,0,0,0,0,2
Kec. Binongko Kab. Wakatobi,0,0,0,0,0,0
Kec. Tomia Kab. Wakatobi,2,0,0,0,0,2
Kec. Kaledupa Kab. Wakatobi,1,1,0,0,0,2
Kec. Wangi-Wangi Kab. Wakatobi,1,1,0,0,0,2
Kec. Wangi-Wangi Selatan Kab. Wakatobi,0,2,0,0,0,2
Kec. Kaledupa Selatan Kab. Wakatobi,0,0,0,0,0,0
Kec. Tomia Timur Kab. Wakatobi,0,0,0,0,0,0
Kec. Togo Binongko Kab. Wakatobi,0,0,0,0,0,0
Kec. Kabaena Timur Kab. Bombana,0,0,0,0,0,0
Kec. Poleang Kab. Bombana,1,1,0,0,0,2
Kec. Poleang Timur Kab. Bombana,0,0,0,0,0,0
Kec. Rumbia Kab. Bombana,1,1,0,0,0,2
Kec. Rarowatu Kab. Bombana,0,0,0,0,0,0
Kec. Poleang Barat Kab. Bombana,0,0,0,0,0,0
Kec. Mataoleo Kab. Bombana,0,0,0,0,0,0
Kec. Rarowatu Utara Kab. Bombana,2,0,0,0,0,2
Kec. Poleang Utara Kab. Bombana,2,0,0,0,0,2
Kec. Poleang Selatan Kab. Bombana,0,0,0,0,0,0
Kec. Poleang Tenggara Kab. Bombana,0,0,0,0,0,0
Kec. Kabaena Barat Kab. Bombana,0,0,0,0,0,0
Kec. Kabaena Tengah Kab. Bombana,0,0,0,0,0,0
Kec. Kep. Masaloka Raya Kab. Bombana,0,0,0,0,0,0
Kec. Rumbia Tengah Kab. Bombana,0,1,0,0,0,1
Kec. Poleang Tengah Kab. Bombana,0,0,0,0,0,0
Kec. Tontonunu Kab. Bombana,0,0,0,0,0,0
Kec. Lantari Jaya Kab. Bombana,0,0,0,0,0,0
Kec. Mata Usu Kab. Bombana,0,0,0,0,0,0
Kec. Lasusua Kab. Kolaka Utara,1,1,0,0,0,2
Kec. Pakue Kab. Kolaka Utara,2,0,0,0,0,2
Kec. Batuputih Kab. Kolaka Utara,0,2,0,0,0,2
Kec. Kodeoha Kab. Kolaka Utara,3,0,0,0,0,3
Kec. Pakue Tengah Kab. Kolaka Utara,1,1,0,0,0,2
Kec. Porehu Kab. Kolaka Utara,0,0,0,0,0,0
Kec. Katoi Kab. Kolaka Utara,0,0,0,0,0,0
Kec. Tolala Kab. Kolaka Utara,0,0,0,0,0,0
Kec. Watubangga Kab. Kolaka,2,0,0,0,0,2
Kec. Pomalaa Kab. Kolaka,1,3,0,0,0,4
Kec. Wundulako Kab. Kolaka,2,0,0,0,0,2
Kec. Kolaka Kab. Kolaka,7,0,0,0,0,7
Kec. Wolo Kab. Kolaka,3,1,0,0,0,4
Kec. Tanggetada Kab. Kolaka,0,0,0,0,0,0
Kec. Latambaga Kab. Kolaka,2,0,0,0,0,2
Kec. Samaturu Kab. Kolaka,0,0,0,0,0,0
Kec. Toari Kab. Kolaka,0,0,0,0,0,0
Kec. Seram Timur Kab. Seram Bagian Timur,2,0,0,0,0,2
Kec. Werinama Kab. Seram Bagian Timur,0,0,0,0,0,0
Kec. Bula Kab. Seram Bagian Timur,0,2,0,0,0,2
Kec. Pulau Gorom Kab. Seram Bagian Timur,1,1,0,0,0,2
Kec. Wakate Kab. Seram Bagian Timur,4,0,0,0,0,4
Kec. Tutuk Tolu Kab. Seram Bagian Timur,0,0,0,0,0,0
Kec. Siwalalat Kab. Seram Bagian Timur,0,0,0,0,0,0
Kec. Kilmury Kab. Seram Bagian Timur,0,0,0,0,0,0
Kec. Pulau Panjang Kab. Seram Bagian Timur,0,0,0,0,0,0
Kec. Teor Kab. Seram Bagian Timur,0,0,0,0,0,0
Kec. Gorom Timur Kab. Seram Bagian Timur,0,0,0,0,0,0
Kec. Bula Barat Kab. Seram Bagian Timur,0,0,0,0,0,0
Kec. Kian Darat Kab. Seram Bagian Timur,0,0,0,0,0,0
Kec. Siritaun Wida Timur Kab. Seram Bagian Timur,0,0,0,0,0,0
Kec. Pulau-Pulau Aru Kab. Kepulauan Aru,2,2,0,0,0,4
Kec. Aru Tengah Kab. Kepulauan Aru,0,0,0,0,0,0
Kec. Aru Selatan Kab. Kepulauan Aru,0,0,0,0,0,0
Kec. Aru Tengah Timur Kab. Kepulauan Aru,0,0,0,0,0,0
Kec. Aru Tengah Selatan Kab. Kepulauan Aru,0,0,0,0,0,0
Kec. Aru Utara Kab. Kepulauan Aru,0,0,0,0,0,0
Kec. Aru Utara Timur Batuley Kab. Kepulauan Aru,0,0,0,0,0,0
Kec. Nusaniwe Kota Ambon,13,5,0,0,0,18
Kec. Sirimau Kota Ambon,15,7,0,0,0,22
Kec. Teluk Ambon  Kota Ambon,6,4,0,0,0,10
Kec. Baguala Kota Ambon,14,2,0,0,0,16
Kec. Lei Timur Selatan Kota Ambon,1,1,0,0,0,2
Kec. Pulau Dullah Selatan Kota Tual,6,2,0,0,0,8
Kec. Pulau Dullah Utara Kota Tual,0,0,0,0,0,0
Kec. Tayando Tam Kota Tual,0,0,0,0,0,0
Kec. Kur Selatan Kota Tual,0,0,0,0,0,0
Kec. Banda Kab. Maluku Tengah,1,3,0,0,0,4
Kec. Tehoru Kab. Maluku Tengah,2,0,0,0,0,2
Kec. Amahai Kab. Maluku Tengah,4,0,0,0,0,4
Kec. Teon Nila Serua Kab. Maluku Tengah,0,0,0,0,0,0
Kec. Saparua Kab. Maluku Tengah,8,2,0,0,0,10
Kec. Pulau Haruku Kab. Maluku Tengah,4,2,0,0,0,6
Kec. Salahutu Kab. Maluku Tengah,6,0,0,0,0,6
Kec. Leihitu Kab. Maluku Tengah,4,0,0,0,0,4
Kec. Seram Utara Kab. Maluku Tengah,0,0,0,0,0,0
Kec. Masohi Kab. Maluku Tengah,2,2,0,0,0,4
Kec. Nusa Laut Kab. Maluku Tengah,1,1,0,0,0,2
Kec. Teluk Elpaputih Kab. Maluku Tengah,1,1,0,0,0,2
Kec. Seram Utara Barat Kab. Maluku Tengah,0,2,0,0,0,2
Kec. Leihitu Barat Kab. Maluku Tengah,0,0,0,0,0,0
Kec. Telutih Kab. Maluku Tengah,0,0,0,0,0,0
Kec. Seram Utara Timur Seti Kab. Maluku Tengah,0,0,0,0,0,0
Kec. Seram Utara Timur Kobi Kab. Maluku Tengah,0,0,0,0,0,0
Kec. Saparua Timur Kab. Maluku Tengah,5,1,0,0,0,6
Kec. Kei Kecil Kab. Maluku Tenggara,9,5,0,0,0,14
Kec. Kei Besar Kab. Maluku Tenggara,0,0,0,0,0,0
Kec. Kei Besar Selatan Kab. Maluku Tenggara,0,0,0,0,0,0
Kec. Kei Besar Utara Timur Kab. Maluku Tenggara,0,0,0,0,0,0
Kec. Kei Kecil Barat Kab. Maluku Tenggara,0,0,0,0,0,0
Kec. Kei Kecil Timur Kab. Maluku Tenggara,0,0,0,0,0,0
Kec. Hoat Sorbay Kab. Maluku Tenggara,2,0,0,0,0,2
Kec. Kei Kecil Timur Selatan Kab. Maluku Tenggara,0,0,0,0,0,0
Kec. Babar Timur Kab. Maluku Barat Daya,0,0,0,0,0,0
Kec. Mdona Hiera Kab. Maluku Barat Daya,0,0,0,0,0,0
Kec. Moa Lakor Kab. Maluku Barat Daya,0,0,0,0,0,0
Kec. Pulau Letti Kab. Maluku Barat Daya,1,0,0,0,0,1
Kec. Wetar Kab. Maluku Barat Daya,0,0,0,0,0,0
Kec. Damer Kab. Maluku Barat Daya,6,0,0,0,0,6
Kec. Pulau-pulau Babar Kab. Maluku Barat Daya,1,1,0,0,0,2
Kec. Pulau-pulau Terselatan Kab. Maluku Barat Daya,2,2,0,0,0,4
Kec. Pulau Masela Kab. Maluku Barat Daya,0,0,0,0,0,0
Kec. Dawelor Dawera Kab. Maluku Barat Daya,0,0,0,0,0,0
Kec. Pulau Wetang Kab. Maluku Barat Daya,0,0,0,0,0,0
Kec. Pulau Lakor Kab. Maluku Barat Daya,0,0,0,0,0,0
Kec. Wetar Timur Kab. Maluku Barat Daya,0,0,0,0,0,0
Kec. Ambalau Kab. Buru Selatan,0,0,0,0,0,0
Kec. Kepala Madan Kab. Buru Selatan,0,0,0,0,0,0
Kec. Leksula Kab. Buru Selatan,1,1,0,0,0,2
Kec. Namrole Kab. Buru Selatan,1,1,0,0,0,2
Kec. Waesama Kab. Buru Selatan,0,2,0,0,0,2
Kec. Airbuaya Kab. Buru,0,0,0,0,0,0
Kec. Waeapo Kab. Buru,0,0,0,0,0,0
Kec. Namlea Kab. Buru,2,2,0,0,0,4
Kec. Waplau Kab. Buru,0,0,0,0,0,0
Kec. Batabual Kab. Buru,0,0,0,0,0,0
Kec. Lolong Guba Kab. Buru,0,0,0,0,0,0
Kec. Waelata Kab. Buru,0,0,0,0,0,0
Kec. Lilialy Kab. Buru,0,0,0,0,0,0
Kec. Tanimbar Selatan Kab. Kepulauan Tanimbar,1,3,0,0,0,4
Kec. Tanimbar Utara Kab. Kepulauan Tanimbar,2,0,0,0,0,2
Kec. Wer Tamrian Kab. Kepulauan Tanimbar,0,0,0,0,0,0
Kec. Wer Maktian Kab. Kepulauan Tanimbar,4,0,0,0,0,4
Kec. Selaru Kab. Kepulauan Tanimbar,1,1,0,0,0,2
Kec. Yaru Kab. Kepulauan Tanimbar,0,0,0,0,0,0
Kec. Wuar Labobar Kab. Kepulauan Tanimbar,0,0,0,0,0,0
Kec. Nirun Mas Kab. Kepulauan Tanimbar,0,0,0,0,0,0
Kec. Kormomolin Kab. Kepulauan Tanimbar,0,0,0,0,0,0
Kec. Molu Maru Kab. Kepulauan Tanimbar,0,0,0,0,0,0
Kec. Kairatu Kab. Seram Bagian Barat,1,1,0,0,0,2
Kec. Seram Barat Kab. Seram Bagian Barat,5,1,0,0,0,6
Kec. Taniwel Kab. Seram Bagian Barat,3,1,0,0,0,4
Kec. Huamual Kab. Seram Bagian Barat,0,0,0,0,0,0
Kec. Amalatu Kab. Seram Bagian Barat,1,0,0,0,0,1
Kec. Elpaputih Kab. Seram Bagian Barat,2,0,0,0,0,2
Kec. Taniwel Timur Kab. Seram Bagian Barat,0,0,0,0,0,0
Kec. Huamual Belakang Kab. Seram Bagian Barat,2,2,0,0,0,4
Kec. Kepulauan Manipa Kab. Seram Bagian Barat,1,1,0,0,0,2
Kec. Kairatu Barat Kab. Seram Bagian Barat,0,2,0,0,0,2
Kec. Gerokgak Kab. Buleleng,4,0,0,0,0,4
Kec. Seririt Kab. Buleleng,1,1,0,0,0,2
Kec. Busungbiu Kab. Buleleng,2,0,0,0,0,2
Kec. Banjar Kab. Buleleng,6,0,0,0,0,6
Kec. Sukasada Kab. Buleleng,4,0,0,0,0,4
Kec. Buleleng Kab. Buleleng,13,3,0,0,0,16
Kec. Sawan Kab. Buleleng,1,1,0,0,0,2
Kec. Kubutambahan Kab. Buleleng,6,0,0,0,0,6
Kec. Tejakula Kab. Buleleng,3,1,0,0,0,4
Kec. Melaya Kab. Jembrana,3,1,0,0,0,4
Kec. Negara Kab. Jembrana,6,2,0,0,0,8
Kec. Mendoyo Kab. Jembrana,4,0,0,0,0,4
Kec. Pekutatan Kab. Jembrana,0,0,0,0,0,0
Kec. Jembrana Kab. Jembrana,4,2,0,0,0,6
Kec. Selemadeg Kab. Tabanan,0,0,0,0,0,0
Kec. Kerambitan Kab. Tabanan,2,0,0,0,0,2
Kec. Tabanan Kab. Tabanan,6,0,0,0,0,6
Kec. Kediri Kab. Tabanan,3,1,0,0,0,4
Kec. Marga Kab. Tabanan,2,0,0,0,0,2
Kec. Baturiti Kab. Tabanan,1,1,0,0,0,2
Kec. Penebel Kab. Tabanan,2,0,0,0,0,2
Kec. Pupuan Kab. Tabanan,2,0,0,0,0,2
Kec. Kuta Selatan Kab. Badung,12,0,0,0,0,12
Kec. Kuta Kab. Badung,9,3,0,0,0,12
Kec. Kuta Utara Kab. Badung,9,1,0,0,0,10
Kec. Mengwi Kab. Badung,7,3,0,0,0,10
Kec. Abiansemal Kab. Badung,6,0,0,0,0,6
Kec. Petang Kab. Badung,1,1,0,0,0,2
Kec. Sukawati Kab. Gianyar,1,1,0,0,0,2
Kec. Blahbatuh Kab. Gianyar,4,0,0,0,0,4
Kec. Gianyar Kab. Gianyar,2,2,0,0,0,4
Kec. Tampaksiring Kab. Gianyar,2,2,0,0,0,4
Kec. Ubud Kab. Gianyar,5,1,0,0,0,6
Kec. Tegallalang Kab. Gianyar,1,1,0,0,0,2
Kec. Payangan Kab. Gianyar,2,0,0,0,0,2
Kec. Nusapenida Kab. Klungkung,4,0,0,0,0,4
Kec. Banjarangkan Kab. Klungkung,2,0,0,0,0,2
Kec. Klungkung Kab. Klungkung,9,3,0,0,0,12
Kec. Dawan Kab. Klungkung,2,0,0,0,0,2
Kec. Susut Kab. Bangli,1,1,0,0,0,2
Kec. Bangli Kab. Bangli,5,0,0,0,0,5
Kec. Tembuku Kab. Bangli,2,0,0,0,0,2
Kec. Kintamani Kab. Bangli,2,0,0,0,0,2
Kec. Rendang Kab. Karang Asem,1,1,0,0,0,2
Kec. Sidemen Kab. Karang Asem,0,2,0,0,0,2
Kec. Manggis Kab. Karang Asem,4,0,0,0,0,4
Kec. Karangasem Kab. Karang Asem,9,3,0,0,0,12
Kec. Abang Kab. Karang Asem,2,0,0,0,0,2
Kec. Bebandem Kab. Karang Asem,0,0,0,0,0,0
Kec. Selat Kab. Karang Asem,0,0,0,0,0,0
Kec. Kubu Kab. Karang Asem,2,0,0,0,0,2
Kec. Denpasar Selatan Kota Denpasar,26,3,0,0,0,29
Kec. Denpasar Timur Kota Denpasar,5,1,0,0,0,6
Kec. Denpasar Barat Kota Denpasar,12,0,0,0,0,12
Kec. Denpasar Utara Kota Denpasar,16,2,0,0,0,18
Kec. Lunyuk Kab. Sumbawa,0,2,0,0,0,2
Kec. Alas Kab. Sumbawa,4,0,0,0,0,4
Kec. Batulanteh Kab. Sumbawa,0,0,0,0,0,0
Kec. Sumbawa Kab. Sumbawa,12,6,0,0,0,18
Kec. Moyo Hulu Kab. Sumbawa,2,0,0,0,0,2
Kec. Ropang Kab. Sumbawa,2,0,0,0,0,2
Kec. Plampang Kab. Sumbawa,0,2,0,0,0,2
Kec. Empang Kab. Sumbawa,0,0,0,0,0,0
Kec. Labuhan Badas Kab. Sumbawa,2,0,0,0,0,2
Kec. Alas Barat Kab. Sumbawa,0,0,0,0,0,0
Kec. Labangka Kab. Sumbawa,1,1,0,0,0,2
Kec. Rhee Kab. Sumbawa,2,0,0,0,0,2
Kec. Moyo Utara Kab. Sumbawa,0,0,0,0,0,0
Kec. Maronge Kab. Sumbawa,0,0,0,0,0,0
Kec. Lenangguar Kab. Sumbawa,0,0,0,0,0,0
Kec. Orong Telu Kab. Sumbawa,0,0,0,0,0,0
Kec. Utan Kab. Sumbawa,2,0,0,0,0,2
Kec. Lape Kab. Sumbawa,0,2,0,0,0,2
Kec. Hu`u Kab. Dompu,0,0,0,0,0,0
Kec. Dompu Kab. Dompu,0,2,0,0,0,2
Kec. Woja Kab. Dompu,0,3,0,0,0,3
Kec. Kilo Kab. Dompu,3,1,0,0,0,4
Kec. Kempo Kab. Dompu,1,1,0,0,0,2
Kec. Pekat Kab. Dompu,0,0,0,0,0,0
Kec. Pajo Kab. Dompu,1,1,0,0,0,2
Kec. Manggelewa Kab. Dompu,5,0,0,0,0,5
Kec. Sekotong Kab. Lombok Barat,2,2,0,0,0,4
Kec. Gerung Kab. Lombok Barat,1,3,0,0,0,4
Kec. Labuapi Kab. Lombok Barat,1,3,0,0,0,4
Kec. Kediri Kab. Lombok Barat,0,0,0,0,0,0
Kec. Narmada Kab. Lombok Barat,5,3,0,0,0,8
Kec. Gunung Sari Kab. Lombok Barat,0,2,0,0,0,2
Kec. Kuripan Kab. Lombok Barat,3,1,0,0,0,4
Kec. Lembar Kab. Lombok Barat,0,2,0,0,0,2
Kec. Batu Layar Kab. Lombok Barat,0,0,0,0,0,0
Kec. Lingsar Kab. Lombok Barat,1,1,0,0,0,2
Kec. Praya Barat Kab. Lombok Tengah,2,0,0,0,0,2
Kec. Pujut Kab. Lombok Tengah,1,3,0,0,0,4
Kec. Praya Timur Kab. Lombok Tengah,2,0,0,0,0,2
Kec. Janapria Kab. Lombok Tengah,1,2,0,0,0,3
Kec. Kopang Kab. Lombok Tengah,3,1,0,0,0,4
Kec. Praya Kab. Lombok Tengah,13,8,0,0,0,21
Kec. Jonggat Kab. Lombok Tengah,4,4,0,0,0,8
Kec. Pringgarata Kab. Lombok Tengah,4,0,0,0,0,4
Kec. Batukliang Kab. Lombok Tengah,3,1,0,0,0,4
Kec. Batukliang Utara Kab. Lombok Tengah,0,2,0,0,0,2
Kec. Praya Barat Daya Kab. Lombok Tengah,0,0,0,0,0,0
Kec. Praya Tengah Kab. Lombok Tengah,0,2,0,0,0,2
Kec. Keruak Kab. Lombok Timur,0,0,0,0,0,0
Kec. Sakra Kab. Lombok Timur,0,2,0,0,0,2
Kec. Terara Kab. Lombok Timur,3,1,0,0,0,4
Kec. Sikur Kab. Lombok Timur,1,1,0,0,0,2
Kec. Masbagik Kab. Lombok Timur,4,0,0,0,0,4
Kec. Sukamulia Kab. Lombok Timur,1,1,0,0,0,2
Kec. Selong Kab. Lombok Timur,4,4,0,0,0,8
Kec. Pringgabaya Kab. Lombok Timur,1,1,0,0,0,2
Kec. Aikmel Kab. Lombok Timur,12,0,0,0,0,12
Kec. Sambelia Kab. Lombok Timur,0,0,0,0,0,0
Kec. Labuhan Haji Kab. Lombok Timur,3,1,0,0,0,4
Kec. Suralaga Kab. Lombok Timur,0,0,0,0,0,0
Kec. Sakra Timur Kab. Lombok Timur,0,1,0,0,0,1
Kec. Sakra Barat Kab. Lombok Timur,3,0,0,0,0,3
Kec. Jerowaru Kab. Lombok Timur,0,0,0,0,0,0
Kec. Pringgasela Kab. Lombok Timur,1,1,0,0,0,2
Kec. Montong Gading Kab. Lombok Timur,2,1,0,0,0,3
Kec. Wanasaba Kab. Lombok Timur,1,3,0,0,0,4
Kec. Sembalun Kab. Lombok Timur,0,0,0,0,0,0
Kec. Suela Kab. Lombok Timur,0,2,0,0,0,2
Kec. Monta Kab. Bima,3,1,0,0,0,4
Kec. Bolo Kab. Bima,5,4,0,0,0,9
Kec. Woha Kab. Bima,4,2,0,0,0,6
Kec. Belo Kab. Bima,0,0,0,0,0,0
Kec. Wawo Kab. Bima,1,1,0,0,0,2
Kec. Sape Kab. Bima,2,4,0,0,0,6
Kec. Wera Kab. Bima,0,0,0,0,0,0
Kec. Donggo Kab. Bima,0,0,0,0,0,0
Kec. Sanggar Kab. Bima,2,2,0,0,0,4
Kec. Lambu Kab. Bima,1,1,0,0,0,2
Kec. Tambora Kab. Bima,0,0,0,0,0,0
Kec. Ambalawi Kab. Bima,0,0,0,0,0,0
Kec. Mada pangga Kab. Bima,4,2,0,0,0,6
Kec. Langgudu Kab. Bima,2,2,0,0,0,4
Kec. Soromandi Kab. Bima,2,2,0,0,0,4
Kec. Parado Kab. Bima,0,0,0,0,0,0
Kec. Lambitu Kab. Bima,0,0,0,0,0,0
Kec. Palibelo Kab. Bima,2,0,0,0,0,2
Kec. Jereweh Kab. Sumbawa Barat,1,1,0,0,0,2
Kec. Taliwang Kab. Sumbawa Barat,2,1,0,0,0,3
Kec. Seteluk Kab. Sumbawa Barat,0,2,0,0,0,2
Kec. Brang Rea Kab. Sumbawa Barat,1,1,0,0,0,2
Kec. Sekongkang Kab. Sumbawa Barat,0,0,0,0,0,0
Kec. Maluk Kab. Sumbawa Barat,0,0,0,0,0,0
Kec. Poto Tano Kab. Sumbawa Barat,2,0,0,0,0,2
Kec. Tanjung Kab. Lombok Utara,1,1,0,0,0,2
Kec. Gangga Kab. Lombok Utara,2,0,0,0,0,2
Kec. Bayan Kab. Lombok Utara,0,0,0,0,0,0
Kec. Pemenang Kab. Lombok Utara,0,2,0,0,0,2
Kec. Kayangan Kab. Lombok Utara,2,1,0,0,0,3
Kec. Ampenan Kota Mataram,10,0,0,0,0,10
Kec. Mataram Kota Mataram,4,0,0,0,0,4
Kec. Cakranegara Kota Mataram,6,0,0,0,0,6
Kec. Sekarbela Kota Mataram,4,0,0,0,0,4
Kec. Selaparang Kota Mataram,11,5,0,0,0,16
Kec. Sandubaya Kota Mataram,9,1,0,0,0,10
Kec. RasanaE Barat Kota Bima,3,3,0,0,0,6
Kec. RasanaE Timur Kota Bima,0,0,0,0,0,0
Kec. Asakota Kota Bima,0,0,0,0,0,0
Kec. Raba Kota Bima,7,3,1,0,0,11
Kec. Mpunda Kota Bima,6,0,0,0,0,6
Kec. Semau Kab. Kupang,0,0,0,0,0,0
Kec. Kupang Barat Kab. Kupang,5,2,0,0,0,7
Kec. Kupang Tengah Kab. Kupang,10,0,0,0,0,10
Kec. Amarasi Kab. Kupang,2,0,0,0,0,2
Kec. Kupang Timur Kab. Kupang,0,1,0,0,0,1
Kec. Sulamu Kab. Kupang,0,0,0,0,0,0
Kec. Fatuleu Kab. Kupang,1,1,0,0,0,2
Kec. Takari Kab. Kupang,0,0,0,0,0,0
Kec. Amfoang Selatan Kab. Kupang,0,0,0,0,0,0
Kec. Amfoang Utara Kab. Kupang,2,0,0,0,0,2
Kec. Nekamese Kab. Kupang,0,0,0,0,0,0
Kec. Amabi Oefeto Timur Kab. Kupang,0,0,0,0,0,0
Kec. Amarasi Selatan Kab. Kupang,0,0,0,0,0,0
Kec. Amarasi Timur Kab. Kupang,3,1,0,0,0,4
Kec. Amarasi Barat Kab. Kupang,0,0,0,0,0,0
Kec. Amfoang Barat Daya Kab. Kupang,2,0,0,0,0,2
Kec. Amfoang Barat Laut Kab. Kupang,0,0,0,0,0,0
Kec. Semau Selatan Kab. Kupang,0,0,0,0,0,0
Kec. Taebenu Kab. Kupang,4,0,0,0,0,4
Kec. Amabi Oefeto  Kab. Kupang,0,0,0,0,0,0
Kec. Fatuleu Tengah Kab. Kupang,6,0,0,0,0,6
Kec. Fatuleu Barat Kab. Kupang,0,0,0,0,0,0
Kec. Amfoang Timur Kab. Kupang,0,0,0,0,0,0
Kec. Amfoang Tengah Kab. Kupang,0,2,0,0,0,2
Kec. Mollo Utara Kab. Timor Tengah Selatan,4,0,0,0,0,4
Kec. Mollo Selatan Kab. Timor Tengah Selatan,0,0,0,0,0,0
Kec. Kota Soe Kab. Timor Tengah Selatan,14,0,0,0,0,14
Kec. Amanuban Barat Kab. Timor Tengah Selatan,0,0,0,0,0,0
Kec. Amanuban Selatan Kab. Timor Tengah Selatan,0,0,0,0,0,0
Kec. Kuanfatu Kab. Timor Tengah Selatan,0,0,0,0,0,0
Kec. Amanuban Tengah Kab. Timor Tengah Selatan,2,0,0,0,0,2
Kec. Amanuban Timur Kab. Timor Tengah Selatan,1,1,0,0,0,2
Kec. Kie Kab. Timor Tengah Selatan,0,0,0,0,0,0
Kec. Amanatun Selatan Kab. Timor Tengah Selatan,0,0,0,0,0,0
Kec. Amanatun Utara Kab. Timor Tengah Selatan,0,0,0,0,0,0
Kec. Polen Kab. Timor Tengah Selatan,1,1,0,0,0,2
Kec. BatuPutih Kab. Timor Tengah Selatan,0,0,0,0,0,0
Kec. Boking Kab. Timor Tengah Selatan,0,0,0,0,0,0
Kec. Noebana Kab. Timor Tengah Selatan,1,1,0,0,0,2
Kec. Nunkolo Kab. Timor Tengah Selatan,0,0,0,0,0,0
Kec. Kot`Olin Kab. Timor Tengah Selatan,0,0,0,0,0,0
Kec. Oenino Kab. Timor Tengah Selatan,0,0,0,0,0,0
Kec. Kolbano Kab. Timor Tengah Selatan,0,1,0,0,0,1
Kec. Kualin Kab. Timor Tengah Selatan,2,0,0,0,0,2
Kec. Toianas Kab. Timor Tengah Selatan,0,0,0,0,0,0
Kec. Kok Baun Kab. Timor Tengah Selatan,0,0,0,0,0,0
Kec. Tobu Kab. Timor Tengah Selatan,1,0,0,0,0,1
Kec. Nunbena Kab. Timor Tengah Selatan,0,0,0,0,0,0
Kec. Kuatnana Kab. Timor Tengah Selatan,0,0,0,0,0,0
Kec. Noebeba Kab. Timor Tengah Selatan,0,0,0,0,0,0
Kec. Fatukopa Kab. Timor Tengah Selatan,0,0,0,0,0,0
Kec. Santian Kab. Timor Tengah Selatan,1,1,0,0,0,2
Kec. Naga Wutung Kab. Lembata,2,0,0,0,0,2
Kec. Ile Ape Kab. Lembata,2,0,0,0,0,2
Kec. Lebatukan Kab. Lembata,0,2,0,0,0,2
Kec. Nubatukan Kab. Lembata,5,1,0,0,0,6
Kec. Omesuri Kab. Lembata,2,0,0,0,0,2
Kec. Buyasuri Kab. Lembata,0,0,0,0,0,0
Kec. Wulandoni Kab. Lembata,2,0,0,0,0,2
Kec. Ile Ape Timur Kab. Lembata,0,0,0,0,0,0
Kec. Rote Barat Daya Kab. Rote-Ndao,2,0,0,0,0,2
Kec. Rote Barat Laut Kab. Rote-Ndao,1,1,0,0,0,2
Kec. Lobalain Kab. Rote-Ndao,1,1,0,0,0,2
Kec. Rote Tengah Kab. Rote-Ndao,2,0,0,0,0,2
Kec. Pantai Baru Kab. Rote-Ndao,0,0,0,0,0,0
Kec. Rote Timur Kab. Rote-Ndao,2,0,0,0,0,2
Kec. Rote Barat Kab. Rote-Ndao,0,1,0,0,0,1
Kec. Rote Selatan Kab. Rote-Ndao,0,1,0,0,0,1
Kec. Ndao Nuse Kab. Rote-Ndao,0,0,0,0,0,0
Kec. Komodo Kab. Manggarai Barat,6,0,0,0,0,6
Kec. Sano Nggoang Kab. Manggarai Barat,6,0,0,0,0,6
Kec. Lembor Kab. Manggarai Barat,0,0,0,0,0,0
Kec. Kuwus Kab. Manggarai Barat,2,0,0,0,0,2
Kec. Macang Pacar Kab. Manggarai Barat,1,1,0,0,0,2
Kec. Boleng Kab. Manggarai Barat,0,0,0,0,0,0
Kec. Welak Kab. Manggarai Barat,0,0,0,0,0,0
Kec. Ndoso Kab. Manggarai Barat,0,0,0,0,0,0
Kec. Lembor Selatan Kab. Manggarai Barat,0,0,0,0,0,0
Kec. Mbeliling Kab. Manggarai Barat,0,0,0,0,0,0
Kec. Alor Barat Daya Kab. Alor,6,0,0,0,0,6
Kec. Alor Selatan Kab. Alor,1,1,0,0,0,2
Kec. Alor Timur Kab. Alor,6,0,0,0,0,6
Kec. Teluk Mutiara Kab. Alor,11,3,0,0,0,14
Kec. Alor Barat Laut Kab. Alor,0,0,0,0,0,0
Kec. Pantar Kab. Alor,1,1,0,0,0,2
Kec. Alor Timur Laut Kab. Alor,0,0,0,0,0,0
Kec. Alor Tengah Utara Kab. Alor,0,0,0,0,0,0
Kec. Pantar Barat Kab. Alor,0,2,0,0,0,2
Kec. Pantar Timur Kab. Alor,1,1,0,0,0,2
Kec. Pantar Barat Laut Kab. Alor,0,0,0,0,0,0
Kec. Pantar Tengah Kab. Alor,2,0,0,0,0,2
Kec. Mataru Kab. Alor,0,0,0,0,0,0
Kec. Pureman Kab. Alor,0,0,0,0,0,0
Kec. Kabola Kab. Alor,1,2,0,0,0,3
Kec. Pulau Pura Kab. Alor,0,0,0,0,0,0
Kec. Lembur Kab. Alor,0,0,0,0,0,0
Kec. Wulang Gitang Kab. Flores Timur,4,0,0,0,0,4
Kec. Tanjung Bunga Kab. Flores Timur,0,2,0,0,0,2
Kec. Larantuka Kab. Flores Timur,11,1,0,0,0,12
Kec. Solor Barat Kab. Flores Timur,0,0,0,0,0,0
Kec. Adonara Barat Kab. Flores Timur,2,0,0,0,0,2
Kec. Adonara Timur Kab. Flores Timur,0,0,0,0,0,0
Kec. Titehena Kab. Flores Timur,0,0,0,0,0,0
Kec. Ile Boleng Kab. Flores Timur,1,1,0,0,0,2
Kec. Witihama Kab. Flores Timur,1,1,0,0,0,2
Kec. Kelubagolit Kab. Flores Timur,0,0,0,0,0,0
Kec. Demon Pagong Kab. Flores Timur,0,0,0,0,0,0
Kec. Lewolema Kab. Flores Timur,0,0,0,0,0,0
Kec. Adonara Kab. Flores Timur,0,0,0,0,0,0
Kec. Adonara Tengah Kab. Flores Timur,2,0,0,0,0,2
Kec. Solor Selatan Kab. Flores Timur,0,2,0,0,0,2
Kec. Elar Kab. Manggarai Timur,2,0,0,0,0,2
Kec. Kota Komba Kab. Manggarai Timur,7,1,0,0,0,8
Kec. Lamba Leda Kab. Manggarai Timur,3,1,0,0,0,4
Kec. Poco Ranaka Kab. Manggarai Timur,2,0,0,0,0,2
Kec. Sambi Rampas Kab. Manggarai Timur,6,2,0,0,0,8
Kec. Borong Kab. Manggarai Timur,7,3,0,0,0,10
Kec. Rana Mese Kab. Manggarai Timur,3,1,0,0,0,4
Kec. Poco Ranaka Timur Kab. Manggarai Timur,0,0,0,0,0,0
Kec. Elar Selatan Kab. Manggarai Timur,4,0,0,0,0,4
Kec. Hawu Mehara Kab. Sabu Raijua,0,0,0,0,0,0
Kec. Sabu Tengah Kab. Sabu Raijua,0,0,0,0,0,0
Kec. Raijua Kab. Sabu Raijua,0,0,0,0,0,0
Kec. Sabu Liae Kab. Sabu Raijua,0,0,0,0,0,0
Kec. Sabu Barat Kab. Sabu Raijua,2,0,0,0,0,2
Kec. Sabu Timur Kab. Sabu Raijua,2,0,0,0,0,2
Kec. Malaka Barat Kab. Malaka,4,0,0,0,0,4
Kec. Wewiku Kab. Malaka,0,0,0,0,0,0
Kec. Weliman Kab. Malaka,0,0,0,0,0,0
Kec. Rinhat Kab. Malaka,0,0,0,0,0,0
Kec. Io Kufeu Kab. Malaka,0,0,0,0,0,0
Kec. Sasitamean Kab. Malaka,0,1,0,0,0,1
Kec. Laenmanen Kab. Malaka,0,0,0,0,0,0
Kec. Malaka Timur Kab. Malaka,0,0,0,0,0,0
Kec. Kobalima Timur Kab. Malaka,0,0,0,0,0,0
Kec. Kobalima Kab. Malaka,2,0,0,0,0,2
Kec. Botin Leobele Kab. Malaka,0,0,0,0,0,0
Kec. Malaka Tengah Kab. Malaka,0,0,0,0,0,0
Kec. Aimere Kab. Ngada,1,3,0,0,0,4
Kec. Bajawa Kab. Ngada,3,1,0,0,0,4
Kec. Golewa Kab. Ngada,7,1,0,0,0,8
Kec. Golewa Barat Kab. Ngada,2,0,0,0,0,2
Kec. Riung Kab. Ngada,0,0,0,0,0,0
Kec. Riung Barat Kab. Ngada,0,0,0,0,0,0
Kec. Soa Kab. Ngada,0,0,0,0,0,0
Kec. Jerebuu Kab. Ngada,0,0,0,0,0,0
Kec. Riung Selatan (Wolomeze) Kab. Ngada,0,0,0,0,0,0
Kec. Inerie Kab. Ngada,0,0,0,0,0,0
Kec. Golewa Selatan Kab. Ngada,0,0,0,0,0,0
Kec. Alak Kota Kupang,5,1,0,0,0,6
Kec. Maulafa Kota Kupang,15,3,0,0,0,18
Kec. Oebobo Kota Kupang,21,5,0,0,0,26
Kec. Kelapa Lima Kota Kupang,5,3,0,0,0,8
Kec. Kota Raja Kota Kupang,7,1,0,0,0,8
Kec. Kota Lama Kota Kupang,3,1,0,0,0,4
Kec. Paga Kab. Sikka,0,0,0,0,0,0
Kec. Bola Kab. Sikka,0,0,0,0,0,0
Kec. Talibura Kab. Sikka,0,0,0,0,0,0
Kec. Kewapante Kab. Sikka,2,0,0,0,0,2
Kec. Nita Kab. Sikka,0,0,0,0,0,0
Kec. Alok Kab. Sikka,21,1,0,0,0,22
Kec. Waigete Kab. Sikka,2,0,0,0,0,2
Kec. Waiblama Kab. Sikka,0,0,0,0,0,0
Kec. Alok Timur Kab. Sikka,5,1,0,0,0,6
Kec. Magependa Kab. Sikka,0,0,0,0,0,0
Kec. Hewokloang Kab. Sikka,0,0,0,0,0,0
Kec. Kangae Kab. Sikka,0,0,0,0,0,0
Kec. Nangapanda Kab. Ende,0,2,0,0,0,2
Kec. Ende Selatan Kab. Ende,1,1,0,0,0,2
Kec. Wolowaru Kab. Ende,0,0,0,0,0,0
Kec. Maurole Kab. Ende,0,0,0,0,0,0
Kec. Detusoko Kab. Ende,0,0,0,0,0,0
Kec. Wewaria Kab. Ende,0,0,0,0,0,0
Kec. Wolojita Kab. Ende,0,0,0,0,0,0
Kec. Pulau Ende Kab. Ende,0,0,0,0,0,0
Kec. Lio Timur Kab. Ende,0,0,0,0,0,0
Kec. Ende Utara Kab. Ende,3,3,0,0,0,6
Kec. Ende Tengah Kab. Ende,7,1,0,0,0,8
Kec. Ende Timur Kab. Ende,6,0,0,0,0,6
Kec. Miomafo Barat Kab. Timor Tengah Utara,0,0,0,0,0,0
Kec. Miomafo Timur Kab. Timor Tengah Utara,0,0,0,0,0,0
Kec. Kota Kefamenanu Kab. Timor Tengah Utara,11,1,0,0,0,12
Kec. Insana Kab. Timor Tengah Utara,0,0,0,0,0,0
Kec. Biboki Selatan Kab. Timor Tengah Utara,0,0,0,0,0,0
Kec. Biboki Utara Kab. Timor Tengah Utara,0,0,0,0,0,0
Kec. Noemuti Kab. Timor Tengah Utara,4,0,0,0,0,4
Kec. Insana Utara Kab. Timor Tengah Utara,2,0,0,0,0,2
Kec. Biboki Anleu Kab. Timor Tengah Utara,0,0,0,0,0,0
Kec. Noemuti Timur Kab. Timor Tengah Utara,0,0,0,0,0,0
Kec. Miomafo Tengah Kab. Timor Tengah Utara,0,0,0,0,0,0
Kec. Mutis Kab. Timor Tengah Utara,2,0,0,0,0,2
Kec. Bikomi Tengah Kab. Timor Tengah Utara,0,0,0,0,0,0
Kec. Bikomi Nilulat Kab. Timor Tengah Utara,0,0,0,0,0,0
Kec. Bikomi Utara Kab. Timor Tengah Utara,0,0,0,0,0,0
Kec. Naibenu Kab. Timor Tengah Utara,0,0,0,0,0,0
Kec. Insana Fafinesu Kab. Timor Tengah Utara,0,0,0,0,0,0
Kec. Insana Barat Kab. Timor Tengah Utara,0,0,0,0,0,0
Kec. Insana Tengah Kab. Timor Tengah Utara,0,0,0,0,0,0
Kec. Biboki Tanpah Kab. Timor Tengah Utara,0,0,0,0,0,0
Kec. Biboki Moenleu Kab. Timor Tengah Utara,2,0,0,0,0,2
Kec. Tasifeto Barat Kab. Belu,1,3,0,0,0,4
Kec. Kota Atambua Kab. Belu,2,3,0,0,0,5
Kec. Tasifeto Timur Kab. Belu,0,0,0,0,0,0
Kec. Lamakmen Kab. Belu,0,0,0,0,0,0
Kec. Kakuluk Mesak Kab. Belu,0,0,0,0,0,0
Kec. Rai Manuk Kab. Belu,0,0,0,0,0,0
Kec. Lasiolat Kab. Belu,0,0,0,0,0,0
Kec. Atambua Barat Kab. Belu,1,1,0,0,0,2
Kec. Atambua Selatan Kab. Belu,0,0,0,0,0,0
Kec. Aesesa Kab. Nagakeo,5,3,0,0,0,8
Kec. Boawae Kab. Nagakeo,3,1,0,0,0,4
Kec. Keo Tengah Kab. Nagakeo,1,1,0,0,0,2
Kec. Mauponggo Kab. Nagakeo,0,0,0,0,0,0
Kec. Nangaroro Kab. Nagakeo,2,0,0,0,0,2
Kec. Wolowae Kab. Nagakeo,0,0,0,0,0,0
Kec. Katiku Tana Kab. Sumba Tengah,1,1,0,0,0,2
Kec. Mamboro Kab. Sumba Tengah,0,0,0,0,0,0
Kec. Umbu Ratu Nggay Barat Kab. Sumba Tengah,0,0,0,0,0,0
Kec. Katiku Tana Selatan Kab. Sumba Tengah,0,0,0,0,0,0
Kec. Kodi Kab. Sumba Barat Daya,2,0,0,0,0,2
Kec. Kodi Bangedo Kab. Sumba Barat Daya,1,1,0,0,0,2
Kec. Loura Kab. Sumba Barat Daya,0,0,0,0,0,0
Kec. Wewewa Barat Kab. Sumba Barat Daya,2,2,0,0,0,4
Kec. Wewewa Selatan Kab. Sumba Barat Daya,0,0,0,0,0,0
Kec. Wewewa Timur Kab. Sumba Barat Daya,1,1,0,0,0,2
Kec. Wewewa Utara Kab. Sumba Barat Daya,0,0,0,0,0,0
Kec. Kodi Utara Kab. Sumba Barat Daya,1,1,0,0,0,2
Kec. Kota Tambolaka Kab. Sumba Barat Daya,4,0,0,0,0,4
Kec. Wewewa Tengah Kab. Sumba Barat Daya,1,1,0,0,0,2
Kec. Kodi Balaghar Kab. Sumba Barat Daya,1,1,0,0,0,2
Kec. Satarmese Kab. Manggarai,5,1,0,0,0,6
Kec. Langke Rembong Kab. Manggarai,14,0,0,0,0,14
Kec. Ruteng Kab. Manggarai,4,0,0,0,0,4
Kec. Cibal Kab. Manggarai,3,1,0,0,0,4
Kec. Reok Kab. Manggarai,0,0,0,0,0,0
Kec. Satar Mese Barat Kab. Manggarai,0,0,0,0,0,0
Kec. Rahong Utara Kab. Manggarai,0,0,0,0,0,0
Kec. Lelak Kab. Manggarai,0,0,0,0,0,0
Kec. Reok Barat Kab. Manggarai,0,0,0,0,0,0
Kec. Cibal Barat Kab. Manggarai,0,0,0,0,0,0
Kec. Lewa Kab. Sumba Timur,1,1,0,0,0,2
Kec. Paberiwai Kab. Sumba Timur,2,0,0,0,0,2
Kec. Pahunga Lodu Kab. Sumba Timur,0,0,0,0,0,0
Kec. Rindi Kab. Sumba Timur,0,0,0,0,0,0
Kec. Pandawai Kab. Sumba Timur,0,0,0,0,0,0
Kec. Kota Waingapu Kab. Sumba Timur,8,5,0,0,0,13
Kec. Haharu Kab. Sumba Timur,0,0,0,0,0,0
Kec. Nggaha Ori Angu Kab. Sumba Timur,0,0,0,0,0,0
Kec. Umalulu Kab. Sumba Timur,2,0,0,0,0,2
Kec. Kahaungu Eti Kab. Sumba Timur,0,0,0,0,0,0
Kec. Matawai La Pawu Kab. Sumba Timur,0,0,0,0,0,0
Kec. Wulla Waijelu Kab. Sumba Timur,0,0,0,0,0,0
Kec. Kambera Kab. Sumba Timur,1,1,0,0,0,2
Kec. Kanatang Kab. Sumba Timur,0,0,0,0,0,0
Kec. Lewa Tidahu Kab. Sumba Timur,0,0,0,0,0,0
Kec. Loli Kab. Sumba Barat,0,0,0,0,0,0
Kec. Kota Waikabubak Kab. Sumba Barat,5,1,0,0,0,6
Kec. Wanokaka Kab. Sumba Barat,2,0,0,0,0,2
Kec. Lamboya Kab. Sumba Barat,0,0,0,0,0,0
Kec. Tana Righu Kab. Sumba Barat,0,0,0,0,0,0
Kec. Asologaima Kab. Jaya Wijaya,0,0,0,0,0,0
Kec. Kurulu Kab. Jaya Wijaya,0,0,0,0,0,0
Kec. Yalengga Kab. Jaya Wijaya,0,0,0,0,0,0
Kec. Wamena Kab. Jaya Wijaya,2,2,0,0,0,4
Kec. Bolakme Kab. Jaya Wijaya,0,0,0,0,0,0
Kec. Hubikiak Kab. Jaya Wijaya,0,0,0,0,0,0
Kec. Muliama Kab. Jaya Wijaya,0,0,0,0,0,0
Kec. Uwapa Kab. Nabire,0,0,0,0,0,0
Kec. Wanggar Kab. Nabire,2,0,0,0,0,2
Kec. Nabire Kab. Nabire,11,2,0,0,0,13
Kec. Napan Kab. Nabire,0,0,0,0,0,0
Kec. Makimi Kab. Nabire,0,0,0,0,0,0
Kec. Teluk Kimi Kab. Nabire,0,0,0,0,0,0
Kec. Nabire Barat Kab. Nabire,1,1,0,0,0,2
Kec. Yaro  Kab. Nabire,0,0,0,0,0,0
Kec. Waropen Bawah Kab. Waropen,0,2,0,0,0,2
Kec. Ureifaisei Kab. Waropen,2,0,0,0,0,2
Kec. Supiori Selatan Kab. Supiori,2,0,0,0,0,2
Kec. Supiori Timur Kab. Supiori,0,0,0,0,0,0
Kec. Kepulauan Aruri Kab. Supiori,0,0,0,0,0,0
Kec. Supiori Barat Kab. Supiori,0,0,0,0,0,0
Kec. Supiori Utara Kab. Supiori,0,0,0,0,0,0
Kec. Waropen Atas Kab. Memberamo Raya,0,0,0,0,0,0
Kec. Mamberamo Ilir (hilir) Kab. Memberamo Raya,0,0,0,0,0,0
Kec. Mamberamo Tengah Kab. Memberamo Raya,0,0,0,0,0,0
Kec. Mamberamo Ulu (hulu) Kab. Memberamo Raya,0,0,0,0,0,0
Kec. Benuki Kab. Memberamo Raya,0,0,0,0,0,0
Kec. Kenyam Kab. Nduga,0,0,0,0,0,0
Kec. Mbuwa Kab. Nduga,0,0,0,0,0,0
Kec. Mimika Barat Kab. Mimika,0,0,0,0,0,0
Kec. Mimika Timur Kab. Mimika,5,1,0,0,0,6
Kec. Mimika Baru Kab. Mimika,6,0,0,0,0,6
Kec. Iwaka Kab. Mimika,0,2,0,0,0,2
Kec. Wania Kab. Mimika,0,0,0,0,0,0
Kec. Jair Kab. Boven Digoel,0,0,0,0,0,0
Kec. Mindiptana Kab. Boven Digoel,0,0,0,0,0,0
Kec. Mandobo Kab. Boven Digoel,4,0,0,0,0,4
Kec. Kouh Kab. Boven Digoel,0,0,0,0,0,0
Kec. Yaniruma Kab. Boven Digoel,0,0,0,0,0,0
Kec. Edera Kab. Mappi,0,0,0,0,0,0
Kec. Obaa Kab. Mappi,0,0,0,0,0,0
Kec. Assue Kab. Mappi,1,1,0,0,0,2
Kec. Citakmitak Kab. Mappi,0,0,0,0,0,0
Kec. Ilaga kab. Puncak,0,0,0,0,0,0
Kec. Sinak kab. Puncak,0,0,0,0,0,0
Kec. Beoga kab. Puncak,0,0,0,0,0,0
Kec. Kaureh Kab. Jayapura,0,0,0,0,0,0
Kec. Kemtuk Gresi Kab. Jayapura,0,0,0,0,0,0
Kec. Nimboran Kab. Jayapura,0,0,0,0,0,0
Kec. Nimbokrang Kab. Jayapura,0,1,0,0,0,1
Kec. Demta Kab. Jayapura,0,0,0,0,0,0
Kec. Sentani Barat Kab. Jayapura,0,2,0,0,0,2
Kec. Sentani Kab. Jayapura,8,6,0,0,0,14
Kec. Sentani Timur Kab. Jayapura,5,1,0,0,0,6
Kec. Yapsi Kab. Jayapura,0,0,0,0,0,0
Kec. Waibu Kab. Jayapura,0,2,0,0,0,2
Kec. Numfor Barat Kab. Biak Numfor,2,0,0,0,0,2
Kec. Padaido Kab. Biak Numfor,0,0,0,0,0,0
Kec. Biak Kota Kab. Biak Numfor,4,5,0,0,0,9
Kec. Samofa Kab. Biak Numfor,8,4,0,0,0,12
Kec. Yendidori Kab. Biak Numfor,0,2,0,0,0,2
Kec. Biak Utara Kab. Biak Numfor,0,0,0,0,0,0
Kec. Warsa Kab. Biak Numfor,0,0,0,0,0,0
Kec. Biak Barat Kab. Biak Numfor,0,0,0,0,0,0
Kec. Swandiwe Kab. Biak Numfor,0,0,0,0,0,0
Kec. Bruyandori Kab. Biak Numfor,0,0,0,0,0,0
Kec. Oridek Kab. Biak Numfor,0,0,0,0,0,0
Kec. Kanggime Kab. Tolikara,0,0,0,0,0,0
Kec. Karubaga Kab. Tolikara,0,2,0,0,0,2
Kec. Bokondini Kab. Tolikara,0,0,0,0,0,0
Kec. Kembu Kab. Tolikara,0,0,0,0,0,0
Kec. Mapia Kab. Dogiyai,0,0,0,0,0,0
Kec. Kamu Kab. Dogiyai,0,0,0,0,0,0
Kec. Tigi Kab. Deiyai,0,0,0,0,0,0
Kec. Tigi Barat Kab. Deiyai,0,0,0,0,0,0
Kec. Sugapa Kab. Intan Jaya,0,0,0,0,0,0
Kec. Muara Tami Kota Jayapura,0,0,0,0,0,0
Kec. Abepura Kota Jayapura,6,2,0,0,0,8
Kec. Jayapura Selatan Kota Jayapura,9,0,0,0,0,9
Kec. Jayapura Utara Kota Jayapura,6,2,0,0,0,8
Kec. Heram Kota Jayapura,4,1,0,0,0,5
Kec. Oksibil Kab. Pegunungan Bintang,0,0,0,0,0,0
Kec. Borme Kab. Pegunungan Bintang,0,0,0,0,0,0
Kec. Okbibab Kab. Pegunungan Bintang,0,0,0,0,0,0
Kec. Kiwirok Kab. Pegunungan Bintang,0,0,0,0,0,0
Kec. Atsy Kab. Asmat,0,0,0,0,0,0
Kec. Agats Kab. Asmat,1,1,0,0,0,2
Kec. Kurima Kab. Yahukimo,0,0,0,0,0,0
Kec. Anggruk Kab. Yahukimo,0,0,0,0,0,0
Kec. Dekai Kab. Yahukimo,1,1,0,0,0,2
Kec. Paniai Timur Kab. Paniai,2,0,0,0,0,2
Kec. Bibida Kab. Paniai,0,0,0,0,0,0
Kec. Paniai Barat Kab. Paniai,0,0,0,0,0,0
Kec. Yatamo Kab. Paniai,0,0,0,0,0,0
Kec. Kebo Kab. Paniai,0,0,0,0,0,0
Kec. Aradide Kab. Paniai,0,0,0,0,0,0
Kec. Fawi Kab. Puncak Jaya,0,0,0,0,0,0
Kec. Mulia Kab. Puncak Jaya,1,1,0,0,0,2
Kec. Ilu Kab. Puncak Jaya,0,0,0,0,0,0
Kec. Makki Kab. Lanny Jaya,0,0,0,0,0,0
Kec. Pirime Kab. Lanny Jaya,0,0,0,0,0,0
Kec. Tiom Kab. Lanny Jaya,0,0,0,0,0,0
Kec. Balingga Kab. Lanny Jaya,0,0,0,0,0,0
Kec. Tiomneri Kab. Lanny Jaya,0,0,0,0,0,0
Kec. Kobakma Kab. Membramo Tengah,2,0,0,0,0,2
Kec. Ilugwa Kab. Membramo Tengah,0,0,0,0,0,0
Kec. Kelila Kab. Membramo Tengah,0,0,0,0,0,0
Kec. Eragayam Kab. Membramo Tengah,0,0,0,0,0,0
Kec. Welarek Kab. Yalimo,0,0,0,0,0,0
Kec. Apalapsili Kab. Yalimo,0,0,0,0,0,0
Kec. Abenaho Kab. Yalimo,0,2,0,0,0,2
Kec. Elelim Kab. Yalimo,0,0,0,0,0,0
Kec. Yapen Timur Kab. Kepulauan Yapen,0,0,0,0,0,0
Kec. Yapen Selatan Kab. Kepulauan Yapen,4,4,0,0,0,8
Kec. Yapen Barat Kab. Kepulauan Yapen,0,0,0,0,0,0
Kec. Poom Kab. Kepulauan Yapen,0,0,0,0,0,0
Kec. Kimaam Kab. Merauke,2,0,0,0,0,2
Kec. Okaba Kab. Merauke,0,0,0,0,0,0
Kec. Kurik Kab. Merauke,0,0,0,0,0,0
Kec. Merauke Kab. Merauke,7,9,0,0,0,16
Kec. Muting Kab. Merauke,0,0,0,0,0,0
Kec. Semangga Kab. Merauke,0,0,0,0,0,0
Kec. Tanah Miring Kab. Merauke,0,0,0,0,0,0
Kec. Jagebob Kab. Merauke,0,0,0,0,0,0
Kec. Pantai Timur Kab. Sarmi,0,0,0,0,0,0
Kec. Sarmi Kab. Sarmi,3,1,0,0,0,4
Kec. Bonggo Timur Kab. Sarmi,0,0,0,0,0,0
Kec. Waris Kab. Keerom,0,0,0,0,0,0
Kec. Arso Kab. Keerom,2,0,0,0,0,2
Kec. Skanto Kab. Keerom,1,1,0,0,0,2
Kec. Arso Timur Kab. Keerom,0,0,0,0,0,0
Kec. Arso Barat Kab. Keerom,0,0,0,0,0,0
Kec. Teras Terunjam Kab. Muko-muko,2,0,0,0,0,2
Kec. Kota Mukomuko Kab. Muko-muko,4,0,0,0,0,4
Kec. Pondok Suguh Kab. Muko-muko,0,0,0,0,0,0
Kec. Lubuk Pinang Kab. Muko-muko,2,0,0,0,0,2
Kec. Air Rami Kab. Muko-muko,2,0,0,0,0,2
Kec. Malin Deman Kab. Muko-muko,0,0,0,0,0,0
Kec. Sungai Rumbai Kab. Muko-muko,0,0,0,0,0,0
Kec. Teramang Jaya Kab. Muko-muko,0,0,0,0,0,0
Kec. Penarik Kab. Muko-muko,2,0,0,0,0,2
Kec. Selagan Raya Kab. Muko-muko,0,0,0,0,0,0
Kec. Air Dikit Kab. Muko-muko,0,0,0,0,0,0
Kec. XIV Koto Kab. Muko-muko,0,0,0,0,0,0
Kec. Air Manjunto Kab. Muko-muko,1,1,0,0,0,2
Kec. V Koto Kab. Muko-muko,1,1,0,0,0,2
Kec. Kepahiang Kab. Kepahiang,1,1,0,0,0,2
Kec. Bermani Ilir Kab. Kepahiang,1,1,0,0,0,2
Kec. Tebat Karai Kab. Kepahiang,0,2,0,0,0,2
Kec. Ujan Mas Kab. Kepahiang,0,2,0,0,0,2
Kec. Muara Kemumu Kab. Kepahiang,0,0,0,0,0,0
Kec. Kaba Wetan Kab. Kepahiang,0,2,0,0,0,2
Kec. Merigi Kab. Kepahiang,5,1,0,0,0,6
Kec. Talo Kab. Seluma,1,1,0,0,0,2
Kec. Seluma Kab. Seluma,0,3,0,0,0,3
Kec. Sukaraja Kab. Seluma,0,1,0,0,0,1
Kec. Semidang Alas Maras Kab. Seluma,2,2,0,0,0,4
Kec. Semidang Alas Kab. Seluma,7,0,0,0,0,7
Kec. Ilir Talo Kab. Seluma,0,0,0,0,0,0
Kec. Seluma Selatan Kab. Seluma,0,0,0,0,0,0
Kec. Air Periukan Kab. Seluma,1,1,0,0,0,2
Kec. Talang Empat Kab. Bengkulu Tengah,1,2,0,0,0,3
Kec. Karang Tinggi Kab. Bengkulu Tengah,3,0,0,0,0,3
Kec. Taba Penanjung Kab. Bengkulu Tengah,0,1,0,0,0,1
Kec. Pagar Jati Kab. Bengkulu Tengah,1,1,0,0,0,2
Kec. Pondok Kelapa Kab. Bengkulu Tengah,4,0,0,0,0,4
Kec. Pematang Tiga Kab. Bengkulu Tengah,0,2,0,0,0,2
Kec. Pondok Kubang Kab. Bengkulu Tengah,2,0,0,0,0,2
Kec. Enggano Kab. Bengkulu Utara,2,0,0,0,0,2
Kec. Kerkap Kab. Bengkulu Utara,0,2,0,0,0,2
Kec. Arga Makmur Kab. Bengkulu Utara,1,5,0,0,0,6
Kec. Lais Kab. Bengkulu Utara,0,2,0,0,0,2
Kec. Padang Jaya Kab. Bengkulu Utara,2,0,0,0,0,2
Kec. Ketahun Kab. Bengkulu Utara,5,1,0,0,0,6
Kec. Putri Hijau Kab. Bengkulu Utara,0,2,0,0,0,2
Kec. Air Besi Kab. Bengkulu Utara,0,0,0,0,0,0
Kec. Giri Mulia Kab. Bengkulu Utara,0,2,0,0,0,2
Kec. Hulu Palik Kab. Bengkulu Utara,4,0,0,0,0,4
Kec. Air Padang Kab. Bengkulu Utara,0,0,0,0,0,0
Kec. Arma Jaya Kab. Bengkulu Utara,0,0,0,0,0,0
Kec. Ulok Kupai Kab. Bengkulu Utara,0,2,0,0,0,2
Kecamatan Marga Sakti Sebelat Kab. Bengkulu Utara,0,0,0,0,0,0
Kecamatan Pinang Raya Kab. Bengkulu Utara,0,0,0,0,0,0
Kec. Selebar Kota Bengkulu,6,1,0,0,0,7
Kec. Gading Cempaka Kota Bengkulu,6,2,0,0,0,8
Kec. Teluk Segara Kota Bengkulu,0,4,0,0,0,4
Kec. Muara Bangkahulu Kota Bengkulu,3,1,0,0,0,4
Kec. Kampung Melayu Kota Bengkulu,2,0,0,0,0,2
Kec. Ratu Agung Kota Bengkulu,10,2,0,0,0,12
Kec. Ratu Samban Kota Bengkulu,1,5,0,0,0,6
Kec. Sungai Serut Kota Bengkulu,0,2,0,0,0,2
Kec. Singaran Pati Kota Bengkulu,3,1,0,0,0,4
Kec. Lebong Selatan Kab. Lebong,4,0,0,0,0,4
Kec. Lebong Utara Kab. Lebong,1,1,0,0,0,2
Kec. Lebong Atas Kab. Lebong,0,1,0,0,0,1
Kec. Topos Kab. Lebong,2,0,0,0,0,2
Kec. Lebong Sakti Kab. Lebong,3,1,0,0,0,4
Kec. Amen Kab. Lebong,1,1,0,0,0,2
Kec. Pinang Belapis Kab. Lebong,4,0,0,0,0,4
Kec. Kaur Selatan Kab. Kaur,4,3,0,0,0,7
Kec. Kaur Tengah Kab. Kaur,0,1,0,0,0,1
Kec. Kaur Utara Kab. Kaur,0,2,0,0,0,2
Kec. Maje Kab. Kaur,0,1,0,0,0,1
Kec. Nasal Kab. Kaur,0,0,0,0,0,0
Kec. Kinal Kab. Kaur,0,0,0,0,0,0
Kec. Tanjung Kemuning Kab. Kaur,0,2,0,0,0,2
Kec. Luas Kab. Kaur,0,0,0,0,0,0
Kec. Muara Sahung Kab. Kaur,0,2,0,0,0,2
Kec. Lungkang Kule Kab. Kaur,1,1,0,0,0,2
Kec. Kota Padang Kab. Rejang Lebong,2,0,0,0,0,2
Kec. Padang Ulang Tanding Kab. Rejang Lebong,1,0,0,0,0,1
Kec. Curup Kab. Rejang Lebong,5,2,0,0,0,7
Kec. Sindang Kelingi Kab. Rejang Lebong,0,0,0,0,0,0
Kec. Bermani Ulu Kab. Rejang Lebong,2,1,0,0,0,3
Kec. Selupu Rejang Kab. Rejang Lebong,1,1,0,0,0,2
Kec. Sindang Beliti Ilir Kab. Rejang Lebong,2,0,0,0,0,2
Kec. Bindu Riang Kab. Rejang Lebong,1,1,0,0,0,2
Kec. Sindang Beliti Ulu Kab. Rejang Lebong,0,1,0,0,0,1
Kec. Sindang Dataran Kab. Rejang Lebong,2,0,0,0,0,2
Kec. Curup Selatan Kab. Rejang Lebong,0,0,0,0,0,0
Kec. Curup Tengah Kab. Rejang Lebong,2,2,0,0,0,4
Kec. Curup Utara Kab. Rejang Lebong,0,2,0,0,0,2
Kec. Curup Timur Kab. Rejang Lebong,1,1,0,0,0,2
Kec. Manna Kab. Bengkulu Selatan,0,2,0,0,0,2
Kec. Seginim Kab. Bengkulu Selatan,0,2,0,0,0,2
Kec. Pino Kab. Bengkulu Selatan,4,0,0,0,0,4
Kec. Kota Manna Kab. Bengkulu Selatan,4,3,0,0,0,7
Kec. Pinoraya Kab. Bengkulu Selatan,2,0,0,0,0,2
Kec. Kedurang Kab. Bengkulu Selatan,2,2,0,0,0,4
Kec. Bunga Mas Kab. Bengkulu Selatan,0,2,0,0,0,2
Kec. Pasar Manna Kab. Bengkulu Selatan,2,0,0,0,0,2
Kec. Ulu Manna Kab. Bengkulu Selatan,0,0,0,0,0,0
Kec. Ternate Selatan Kota Ternate,10,0,0,0,0,10
Kec. Ternate Utara Kota Ternate,7,3,0,0,0,10
Kec. Moti Kota Ternate,2,0,0,0,0,2
Kec. Pulau Batang Dua Kota Ternate,0,0,0,0,0,0
Kec. Ternate Tengah Kota Ternate,5,1,0,0,0,6
Kec. Pulau Hiri Kota Ternate,0,0,0,0,0,0
Kec. Ternate Barat Kota Ternate,0,0,0,0,0,0
Kec. Tidore Selatan Kota Tidore Kepulauan,1,1,0,0,0,2
Kec. Tidore Utara Kota Tidore Kepulauan,0,0,0,0,0,0
Kec. Oba Kota Tidore Kepulauan,0,0,0,0,0,0
Kec. Oba Utara Kota Tidore Kepulauan,0,0,0,0,0,0
Kec. Oba Tengah Kota Tidore Kepulauan,0,0,0,0,0,0
Kec. Oba Selatan Kota Tidore Kepulauan,0,0,0,0,0,0
Kec. Tidore Kota Tidore Kepulauan,2,0,0,0,0,2
Kec. Tidore Timur Kota Tidore Kepulauan,1,1,0,0,0,2
Kec. Tobelo Kab. halmahera Utara,6,3,0,0,0,9
Kec. Tobelo Selatan Kab. halmahera Utara,0,2,0,0,0,2
Kec. Kao Kab. halmahera Utara,0,0,0,0,0,0
Kec. Galela Kab. halmahera Utara,0,0,0,0,0,0
Kec. Malifut Kab. halmahera Utara,0,0,0,0,0,0
Kec. Tobelo Utara Kab. halmahera Utara,2,0,0,0,0,2
Kec. Tobelo Tengah Kab. halmahera Utara,0,0,0,0,0,0
Kec. Tobelo Barat Kab. halmahera Utara,0,0,0,0,0,0
Kec. Galela Barat Kab. halmahera Utara,0,0,0,0,0,0
Kec. Galela Utara Kab. halmahera Utara,0,0,0,0,0,0
Kec. Loloda Kepulauan Kab. halmahera Utara,0,0,0,0,0,0
Kec. Kao Utara Kab. halmahera Utara,0,0,0,0,0,0
Kec. Kao Barat Kab. halmahera Utara,2,0,0,0,0,2
Kec. Bacan Timur Kab. Halmahera Selatan,0,0,0,0,0,0
Kec. Bacan Barat Kab. Halmahera Selatan,0,0,0,0,0,0
Kec. Bacan Kab. Halmahera Selatan,1,1,0,0,0,2
Kec. Obi Kab. Halmahera Selatan,2,0,0,0,0,2
Kec. Gane Barat Kab. Halmahera Selatan,0,0,0,0,0,0
Kec. Gane Timur Kab. Halmahera Selatan,0,0,0,0,0,0
Kec. Kayoa Kab. Halmahera Selatan,0,0,0,0,0,0
Kec. Pulau Makian Kab. Halmahera Selatan,1,1,0,0,0,2
Kec. Obi Selatan Kab. Halmahera Selatan,0,0,0,0,0,0
Kec. Obi Barat Kab. Halmahera Selatan,0,0,0,0,0,0
Kec. Obi Timur Kab. Halmahera Selatan,0,0,0,0,0,0
Kec. Obi Utara Kab. Halmahera Selatan,0,0,0,0,0,0
Kec. Mandioli Selatan Kab. Halmahera Selatan,0,0,0,0,0,0
Kec. Mandioli Utara Kab. Halmahera Selatan,0,0,0,0,0,0
Kec. Bacan Selatan Kab. Halmahera Selatan,2,0,0,0,0,2
Kec. Kepulauan Botang Lomang Kab. Halmahera Selatan,2,0,0,0,0,2
Kec. Bacan Timur Selatan Kab. Halmahera Selatan,0,0,0,0,0,0
Kec. Bacan Timur Tengah Kab. Halmahera Selatan,0,0,0,0,0,0
Kec. Kasiruta Barat Kab. Halmahera Selatan,0,0,0,0,0,0
Kec. Kayoa Barat Kab. Halmahera Selatan,0,0,0,0,0,0
Kec. Kayoa Selatan Kab. Halmahera Selatan,0,0,0,0,0,0
Kec. Kayoa Utara Kab. Halmahera Selatan,0,0,0,0,0,0
Kec. Makian Barat Kab. Halmahera Selatan,0,0,0,0,0,0
Kec. Kepulauan Joronga Kab. Halmahera Selatan,0,0,0,0,0,0
Kec. Gane Timur Tengah Kab. Halmahera Selatan,0,0,0,0,0,0
Kec. Gane Timur Selatan Kab. Halmahera Selatan,0,2,0,0,0,2
Kec. Gane Barat Selatan Kab. Halmahera Selatan,0,0,0,0,0,0
Kec. Gane Barat Utara Kab. Halmahera Selatan,0,0,0,0,0,0
Kec. Taliabu Barat Kab. Pulau Taliabu,0,0,0,0,0,0
Kec. Taliabu Barat Laut Kab. Pulau Taliabu,0,0,0,0,0,0
Kec. Lede Kab. Pulau Taliabu,0,0,0,0,0,0
Kec. Taliabu Utara Kab. Pulau Taliabu,0,0,0,0,0,0
Kec. Taliabu Timur Kab. Pulau Taliabu,0,0,0,0,0,0
Kec. Taliabu Timur Selatan Kab. Pulau Taliabu,0,0,0,0,0,0
Kec. Taliabu Selatan Kab. Pulau Taliabu,0,0,0,0,0,0
Kec. Weda Kab. Halmahera Tengah,0,0,0,0,0,0
Kec. Pulau Gebe Kab. Halmahera Tengah,0,0,0,0,0,0
Kec. Patani Kab. Halmahera Tengah,0,0,0,0,0,0
Kec. Weda Utara Kab. Halmahera Tengah,0,0,0,0,0,0
Kec. Weda Selatan Kab. Halmahera Tengah,0,0,0,0,0,0
Kec. Patani Utara Kab. Halmahera Tengah,0,0,0,0,0,0
Kec. Weda Timur Kab. Halmahera Tengah,0,0,0,0,0,0
Kec. Patani Timur Kab. Halmahera Tengah,0,0,0,0,0,0
Kec. Sahu Kab. Halmahera Barat,0,0,0,0,0,0
Kec. Ibu Kab. Halmahera Barat,7,1,0,0,0,8
Kec. Loloda Kab. Halmahera Barat,0,0,0,0,0,0
Kec. Jailolo Selatan Kab. Halmahera Barat,1,1,0,0,0,2
Kec. Jailolo Kab. Halmahera Barat,0,2,0,0,0,2
Kec. Sahu Timur Kab. Halmahera Barat,0,0,0,0,0,0
Kec. Ibu Selatan Kab. Halmahera Barat,0,0,0,0,0,0
Kec. Jailolo Timur Kab. Halmahera Barat,0,0,0,0,0,0
Kec. Maba Selatan Kab. Halmahera Timur,0,0,0,0,0,0
Kec. Wasile Selatan Kab. Halmahera Timur,0,0,0,0,0,0
Kec. Wasile Kab. Halmahera Timur,2,0,0,0,0,2
Kec. Maba Kab. Halmahera Timur,0,0,0,0,0,0
Kec. Wasile Tengah Kab. Halmahera Timur,0,0,0,0,0,0
Kec. Wasile Utara Kab. Halmahera Timur,0,0,0,0,0,0
Kec. Wasile Timur Kab. Halmahera Timur,0,0,0,0,0,0
Kec. Maba Tengah Kab. Halmahera Timur,0,0,0,0,0,0
Kec. Maba Utara Kab. Halmahera Timur,0,0,0,0,0,0
Kec. Kota Maba Kab. Halmahera Timur,0,0,0,0,0,0
Kec. Sanana Kab. Kepulauan Sula,0,2,0,0,0,2
Kec. Sula Besi Barat Kab. Kepulauan Sula,0,0,0,0,0,0
Kec. Mangoli Timur Kab. Kepulauan Sula,0,0,0,0,0,0
Kec. Mangoli Barat Kab. Kepulauan Sula,0,0,0,0,0,0
Kec. Sula Besi Tengah Kab. Kepulauan Sula,0,0,0,0,0,0
Kec. Sula Besi Timur Kab. Kepulauan Sula,0,0,0,0,0,0
Kec. Mangoli Tengah Kab. Kepulauan Sula,0,0,0,0,0,0
Kec. Mangoli Utara Kab. Kepulauan Sula,0,0,0,0,0,0
Kec. Sula Besi Selatan Kab. Kepulauan Sula,0,0,0,0,0,0
Kec. Morotai Selatan Barat Kab. Kepulauan Morotai,1,1,0,0,0,2
Kec. Morotai Selatan Kab. Kepulauan Morotai,0,0,0,0,0,0
Kec. Morotai Utara Kab. Kepulauan Morotai,2,0,0,0,0,2
Kec. Morotai Jaya Kab. Kepulauan Morotai,0,0,0,0,0,0
Kec. Morotai Timur Kab. Kepulauan Morotai,0,0,0,0,0,0
Kec. Sumur Kab. Pandeglang,0,0,0,0,0,0
Kec. Cibaliung Kab. Pandeglang,1,1,0,0,0,2
Kec. Cikeusik Kab. Pandeglang,0,0,0,0,0,0
Kec. Cigeulis Kab. Pandeglang,0,0,0,0,0,0
Kec. Panimbang Kab. Pandeglang,0,0,0,0,0,0
Kec. Munjul Kab. Pandeglang,2,0,0,0,0,2
Kec. Picung Kab. Pandeglang,2,0,0,0,0,2
Kec. Bojong Kab. Pandeglang,0,0,0,0,0,0
Kec. Pagelaran Kab. Pandeglang,0,0,0,0,0,0
Kec. Labuan Kab. Pandeglang,1,1,0,0,0,2
Kec. Menes Kab. Pandeglang,4,0,0,0,0,4
Kec. Mandalawangi Kab. Pandeglang,0,2,0,0,0,2
Kec. Cimanuk Kab. Pandeglang,0,0,0,0,0,0
Kec. Banjar Kab. Pandeglang,0,0,0,0,0,0
Kec. Pandeglang Kab. Pandeglang,0,0,0,0,0,0
Kec. Cadasari Kab. Pandeglang,0,0,0,0,0,0
Kec. Karang Tanjung Kab. Pandeglang,3,1,0,0,0,4
Kec. Kaduhejo Kab. Pandeglang,1,1,0,0,0,2
Kec. Cikedal Kab. Pandeglang,3,1,0,0,0,4
Kec. Cisata Kab. Pandeglang,1,1,0,0,0,2
Kec. Carita Kab. Pandeglang,1,1,0,0,0,2
Kec. Sukaresmi Kab. Pandeglang,0,0,0,0,0,0
Kec. Sindangresmi Kab. Pandeglang,0,0,0,0,0,0
Kec. Pulosari Kab. Pandeglang,1,1,0,0,0,2
Kec. Majasari Kab. Pandeglang,8,2,0,0,0,10
Kec. Sobang Kab. Pandeglang,0,0,0,0,0,0
Kec. Cisoka Kab. Tangerang,1,1,0,0,0,2
Kec. Tiga raksa Kab. Tangerang,4,1,0,0,0,5
Kec. Cikupa Kab. Tangerang,4,2,0,0,0,6
Kec. Panongan Kab. Tangerang,7,1,0,0,0,8
Kec. Curug Kab. Tangerang,15,1,0,0,0,16
Kec. Legok Kab. Tangerang,6,0,0,0,0,6
Kec. Pagedangan Kab. Tangerang,5,1,0,0,0,6
Kec. Pasar Kemis Kab. Tangerang,11,3,0,0,0,14
Kec. Balaraja Kab. Tangerang,11,1,0,0,0,12
Kec. Kresek Kab. Tangerang,3,3,0,0,0,6
Kec. Kronjo Kab. Tangerang,3,1,0,0,0,4
Kec. Mauk Kab. Tangerang,3,1,0,0,0,4
Kec. Rajeg Kab. Tangerang,5,1,0,0,0,6
Kec. Sepatan Kab. Tangerang,4,0,0,0,0,4
Kec. Pakuhaji Kab. Tangerang,5,1,0,0,0,6
Kec. Teluk naga Kab. Tangerang,5,1,0,0,0,6
Kec. Kosambi Kab. Tangerang,13,1,0,0,0,14
Kec. Jayanti Kab. Tangerang,8,0,0,0,0,8
Kec. Jambe Kab. Tangerang,2,0,0,0,0,2
Kec. Cisauk Kab. Tangerang,4,0,0,0,0,4
Kec. Kemiri Kab. Tangerang,1,1,0,0,0,2
Kec. Sukadiri Kab. Tangerang,6,0,0,0,0,6
Kec. Sukamulya Kab. Tangerang,0,0,0,0,0,0
Kec. Kelapa Dua Kab. Tangerang,25,1,0,0,0,26
Kec. Sindang Jaya Kab. Tangerang,9,1,0,0,0,10
Kec. Sepatan Timur Kab. Tangerang,2,0,0,0,0,2
Kec. Solear Kab. Tangerang,1,1,0,0,0,2
Kec. Gunung Kaler Kab. Tangerang,0,0,0,0,0,0
Kec. Mekar Baru Kab. Tangerang,0,0,0,0,0,0
Kec. Cinangka Kab. Serang,4,2,0,0,0,6
Kec. Padarincang Kab. Serang,0,0,0,0,0,0
Kec. Ciomas Kab. Serang,0,0,0,0,0,0
Kec. Pabuaran Kab. Serang,4,0,0,0,0,4
Kec. Baros Kab. Serang,2,0,0,0,0,2
Kec. Petir Kab. Serang,1,1,0,0,0,2
Kec. Cikeusal Kab. Serang,4,0,0,0,0,4
Kec. Pamarayan Kab. Serang,1,1,0,0,0,2
Kec. Jawilan Kab. Serang,10,0,0,0,0,10
Kec. Kopo Kab. Serang,1,3,0,0,0,4
Kec. Cikande Kab. Serang,5,3,0,0,0,8
Kec. Kragilan Kab. Serang,0,0,0,0,0,0
Kec. Waringinkurung Kab. Serang,4,2,0,0,0,6
Kec. Mancak Kab. Serang,2,0,0,0,0,2
Kec. Anyar Kab. Serang,2,1,0,0,0,3
Kec. Bojonegara Kab. Serang,2,0,0,0,0,2
Kec. Kramatwatu Kab. Serang,4,0,0,0,0,4
Kec. Ciruas Kab. Serang,6,6,0,0,0,12
Kec. Pontang Kab. Serang,2,0,0,0,0,2
Kec. Carenang Kab. Serang,2,2,0,0,0,4
Kec. Tirtayasa Kab. Serang,0,0,0,0,0,0
Kec. Tunjung Teja Kab. Serang,0,0,0,0,0,0
Kec. Kibin Kab. Serang,0,0,0,0,0,0
Kec. Pulo Ampel Kab. Serang,0,0,0,0,0,0
Kec. Binuang Kab. Serang,4,2,0,0,0,6
Kec. Tanara Kab. Serang,2,2,0,0,0,4
Kec. Gunung Sari Kab. Serang,1,3,0,0,0,4
Kec. Bandung Kab. Serang,0,0,0,0,0,0
Kec. Lebak Wangi Kab. Serang,0,0,0,0,0,0
Kec. Ciwandan Kota Cilegon,1,3,0,0,0,4
Kec. Pulomerak Kota Cilegon,1,1,0,0,0,2
Kec. Cilegon Kota Cilegon,1,1,0,0,0,2
Kec. Cibeber Kota Cilegon,4,3,0,0,0,7
Kec. Grogol Kota Cilegon,2,0,0,0,0,2
Kec. Purwakarta Kota Cilegon,2,2,0,0,0,4
Kec. Jombang Kota Cilegon,8,4,0,0,0,12
Kec. Citangkil Kota Cilegon,2,0,0,0,0,2
Kec. Ciledug Kota Tangerang,10,2,0,0,0,12
Kec. Cipondoh Kota Tangerang,13,4,0,0,0,17
Kec. Tangerang Kota Tangerang,24,6,0,0,0,30
Kec. Jati uwung Kota Tangerang,1,1,0,0,0,2
Kec. Batuceper Kota Tangerang,5,1,0,0,0,6
Kec. Benda Kota Tangerang,4,0,0,0,0,4
Kec. Larangan Kota Tangerang,0,0,0,0,0,0
Kec. Karang Tengah Kota Tangerang,5,5,0,0,0,10
Kec. Pinang Kota Tangerang,13,3,0,0,0,16
Kec. Karawaci Kota Tangerang,15,4,0,0,0,19
Kec. Cibodas Kota Tangerang,10,0,0,0,0,10
Kec. Periuk Kota Tangerang,2,0,0,0,0,2
Kec. Neglasari Kota Tangerang,0,2,0,0,0,2
Kec. Cipocok Jaya Kota Serang,3,1,0,0,0,4
Kec. Curug Kota Serang,3,0,0,0,0,3
Kec. Kasemen Kota Serang,0,0,0,0,0,0
Kec. Taktakan Kota Serang,7,0,0,0,0,7
Kec. Walantaka Kota Serang,0,0,0,0,0,0
Kec. Serang Kota Serang,10,6,0,0,0,16
Kec. Ciputat Kota Tangerang Selatan,22,1,0,0,0,23
Kec. Ciputat Timur Kota Tangerang Selatan,12,1,0,0,0,13
Kec. Pamulang Kota Tangerang Selatan,26,8,0,0,0,34
Kec. Pondok Aren Kota Tangerang Selatan,20,8,0,0,0,28
Kec. Serpong Kota Tangerang Selatan,30,2,0,0,0,32
Kec. Serpong Utara Kota Tangerang Selatan,19,0,0,0,0,19
Kec. Setu Kota Tangerang Selatan,26,2,0,0,0,28
Kec. Malingping Kab. Lebak,3,1,0,0,0,4
Kec. Panggarangan Kab. Lebak,0,1,0,0,0,1
Kec. Bayah Kab. Lebak,2,2,0,0,0,4
Kec. Cibeber Kab. Lebak,4,0,0,0,0,4
Kec. Cijaku Kab. Lebak,0,0,0,0,0,0
Kec. Banjarsari Kab. Lebak,0,0,0,0,0,0
Kec. Cileles Kab. Lebak,2,1,0,0,0,3
Kec. Gunung kencana Kab. Lebak,0,0,0,0,0,0
Kec. Bojongmanik Kab. Lebak,0,2,0,0,0,2
Kec. Leuwidamar Kab. Lebak,2,0,0,0,0,2
Kec. Muncang Kab. Lebak,2,0,0,0,0,2
Kec. Cipanas Kab. Lebak,4,2,0,0,0,6
Kec. Sajira Kab. Lebak,3,1,0,0,0,4
Kec. Cimarga Kab. Lebak,2,1,0,0,0,3
Kec. Cikulur Kab. Lebak,2,0,0,0,0,2
Kec. Warunggunung Kab. Lebak,2,0,0,0,0,2
Kec. Cibadak Kab. Lebak,0,0,0,0,0,0
Kec. Rangkasbitung Kab. Lebak,8,5,0,0,0,13
Kec. Maja Kab. Lebak,2,0,0,0,0,2
Kec. Curug bitung Kab. Lebak,0,0,0,0,0,0
Kec. Sobang Kab. Lebak,0,0,0,0,0,0
Kec. Wanasalam Kab. Lebak,2,0,0,0,0,2
Kec. Cilograng Kab. Lebak,5,1,0,0,0,6
Kec. Cihara Kab. Lebak,0,0,0,0,0,0
Kec. Cigemblong Kab. Lebak,0,0,0,0,0,0
Kec. Lebakgedong Kab. Lebak,2,0,0,0,0,2
Kec. Kalanganyar Kab. Lebak,4,0,0,0,0,4
Kec. Kelapa Kab. Bangka Barat,4,0,0,0,0,4
Kec. Tempilang Kab. Bangka Barat,6,0,0,0,0,6
Kec. Muntok Kab. Bangka Barat,2,0,0,0,0,2
Kec. Simpang Teritip Kab. Bangka Barat,2,0,0,0,0,2
Kec. Jebus Kab. Bangka Barat,2,0,0,0,0,2
Kec. Parittiga Kab. Bangka Barat,1,1,0,0,0,2
Kec. Payung Kab. Bangka Selatan,0,0,0,0,0,0
Kec. Simpang Rimba Kab. Bangka Selatan,0,0,0,0,0,0
Kec. Toboali Kab. Bangka Selatan,8,0,0,0,0,8
Kec. Lepar Kab. Bangka Selatan,0,0,0,0,0,0
Kec. Pulau Besar Kab. Bangka Selatan,0,0,0,0,0,0
Kec. Airgegas Kab. Bangka Selatan,1,1,0,0,0,2
Kec. Kep. Pongok Kab. Bangka Selatan,0,0,0,0,0,0
Kec. Gantung Kab. Belitung Timur,2,0,0,0,0,2
Kec. Manggar Kab. Belitung Timur,2,2,0,0,0,4
Kec. Kelapa Kampit Kab. Belitung Timur,0,0,0,0,0,0
Kec. Damar Kab. Belitung Timur,0,2,0,0,0,2
Kec. Simpang Pesak Kab. Belitung Timur,2,0,0,0,0,2
Kec. Rangkui Kota Pangkalpinang,5,1,0,0,0,6
Kec. Bukit Intan Kota Pangkalpinang,6,0,0,0,0,6
Kec. Pangkal Balam Kota Pangkalpinang,4,2,0,0,0,6
Kec. Taman Sari Kota Pangkalpinang,2,2,0,0,0,4
Kec. Gerunggang Kota Pangkalpinang,1,1,0,0,0,2
Kec. Girimaya Kota Pangkalpinang,1,1,0,0,0,2
Kec. Mendo Barat Kab. Bangka,0,0,0,0,0,0
Kec. Merawang Kab. Bangka,2,0,0,0,0,2
Kec. Sungailiat Kab. Bangka,11,1,0,0,0,12
Kec. Belinyu Kab. Bangka,8,0,0,0,0,8
Kec. Puding Besar Kab. Bangka,1,1,0,0,0,2
Kec. Bakam Kab. Bangka,2,0,0,0,0,2
Kec. Pemali Kab. Bangka,2,0,0,0,0,2
Kec. Riau Silip Kab. Bangka,0,0,0,0,0,0
Kec. Membalong Kab. Belitung,2,0,0,0,0,2
Kec. Tanjung Pandan Kab. Belitung,11,1,0,0,0,12
Kec. Sijuk Kab. Belitung,1,1,0,0,0,2
Kec. Koba Kab. Bangka Tengah,4,0,0,0,0,4
Kec. Pangkalan Baru Kab. Bangka Tengah,4,0,0,0,0,4
Kec. Sungai Selan Kab. Bangka Tengah,3,1,0,0,0,4
Kec. Lubuk Besar Kab. Bangka Tengah,2,0,0,0,0,2
Kec. Namang Kab. Bangka Tengah,0,0,0,0,0,0
Kec. Anggrek Kab. Gorontalo Utara,2,0,0,0,0,2
Kec. Atinggola Kab. Gorontalo Utara,2,0,0,0,0,2
Kec. Kwandang Kab. Gorontalo Utara,3,1,0,0,0,4
Kec. Sumalata Kab. Gorontalo Utara,2,0,0,0,0,2
Kec. Tolinggula Kab. Gorontalo Utara,2,0,0,0,0,2
Kec. Gentuma Raya Kab. Gorontalo Utara,0,0,0,0,0,0
Kec. Ponelo Kepulauan Kab. Gorontalo Utara,0,0,0,0,0,0
Kec. Biau Kab. Gorontalo Utara,0,0,0,0,0,0
Kec. Sumalata Timur Kab. Gorontalo Utara,2,0,0,0,0,2
Kec. Kota Barat Kota Gorontalo,3,1,0,0,0,4
Kec. Kota Selatan Kota Gorontalo,0,6,0,0,0,6
Kec. Kota Utara Kota Gorontalo,2,0,0,0,0,2
Kec. Kota Timur Kota Gorontalo,2,0,0,0,0,2
Kec. Kota Tengah Kota Gorontalo,0,0,0,0,0,0
Kec. Sipatana Kota Gorontalo,0,0,0,0,0,0
Kec. Tilamuta Kab. Boalemo,1,1,0,0,0,2
Kec. Paguyaman Kab. Boalemo,1,1,0,0,0,2
Kec. Mananggu Kab. Boalemo,0,0,0,0,0,0
Kec. Dulupi Kab. Boalemo,0,0,0,0,0,0
Kec. Wonosari Kab. Boalemo,0,0,0,0,0,0
Kec. Botumoito Kab. Boalemo,2,0,0,0,0,2
Kec. Paguyaman Pantai Kab. Boalemo,2,0,0,0,0,2
Kec. Batudaa Pantai Kab. Gorontalo,0,0,0,0,0,0
Kec. Batudaa Kab. Gorontalo,2,0,0,0,0,2
Kec. Tibawa Kab. Gorontalo,1,1,0,0,0,2
Kec. Boliyohuto Kab. Gorontalo,3,0,0,0,0,3
Kec. Limboto Kab. Gorontalo,2,2,0,0,0,4
Kec. Telaga Kab. Gorontalo,2,0,0,0,0,2
Kec. Bongomeme Kab. Gorontalo,0,0,0,0,0,0
Kec. Pulubala Kab. Gorontalo,0,0,0,0,0,0
Kec. Tolangohula Kab. Gorontalo,0,1,0,0,0,1
Kec. Mootilango Kab. Gorontalo,0,0,0,0,0,0
Kec. Telaga Biru Kab. Gorontalo,2,0,0,0,0,2
Kec. Limboto Barat Kab. Gorontalo,0,0,0,0,0,0
Kec. Biluhu Kab. Gorontalo,2,0,0,0,0,2
Kec. Asparaga Kab. Gorontalo,0,0,0,0,0,0
Kec. Tilango Kab. Gorontalo,0,0,0,0,0,0
Kec. Bilato Kab. Gorontalo,0,0,0,0,0,0
Kec. Dungaliyo Kab. Gorontalo,1,1,0,0,0,2
Kec. Popayato Kab. Pohuwato,8,0,0,0,0,8
Kec. Marisa Kab. Pohuwato,0,2,0,0,0,2
Kec. Paguat Kab. Pohuwato,2,0,0,0,0,2
Kec. Lemito Kab. Pohuwato,2,0,0,0,0,2
Kec. Randangan Kab. Pohuwato,2,0,0,0,0,2
Kec. Popayato Barat Kab. Pohuwato,0,0,0,0,0,0
Kec. Wanggarasi Kab. Pohuwato,0,0,0,0,0,0
Kec. Buntulia Kab. Pohuwato,0,0,0,0,0,0
Kec. Tapa Kab. Bone Bolango,0,2,0,0,0,2
Kec. Kabila Kab. Bone Bolango,2,0,0,0,0,2
Kec. Suwawa Kab. Bone Bolango,4,2,0,0,0,6
Kec. Bonepantai Kab. Bone Bolango,4,0,0,0,0,4
Kec. Bone Kab. Bone Bolango,0,0,0,0,0,0
Kec. Bulango Ulu Kab. Bone Bolango,2,0,0,0,0,2
Kec. Suwawa Timur Kab. Bone Bolango,2,0,0,0,0,2
Kec. Pinogu Kab. Bone Bolango,0,0,0,0,0,0
Kec. Bintan Utara Kab. Bintan,1,3,0,0,0,4
Kec. Tambelan Kab. Bintan,4,0,0,0,0,4
Kec. Teluk Bintan Kab. Bintan,0,2,0,0,0,2
Kec. Teluk Sebong Kab. Bintan,4,0,0,0,0,4
Kec. Toapaya Kab. Bintan,2,0,0,0,0,2
Kec. Mantang Kab. Bintan,0,0,0,0,0,0
Kec. Bintan Pesisir Kab. Bintan,0,0,0,0,0,0
Kec. Bintan Timur Kab. Bintan,2,0,0,0,0,2
Kec. Moro Kab. Karimun,2,0,0,0,0,2
Kec. Kundur Kab. Karimun,1,1,0,0,0,2
Kec. Karimun Kab. Karimun,5,3,0,0,0,8
Kec. Meral Kab. Karimun,5,1,0,0,0,6
Kec. Tebing Kab. Karimun,6,0,0,0,0,6
Kec. Buru Kab. Karimun,0,0,0,0,0,0
Kec. Kundur Utara Kab. Karimun,0,2,0,0,0,2
Kec. Kundur Barat Kab. Karimun,2,0,0,0,0,2
Kec. Durai Kab. Karimun,2,0,0,0,0,2
Kec. Belat Kab. Karimun,0,0,0,0,0,0
Kec. Midai Kab. Natuna,2,0,0,0,0,2
Kec. Bunguran Barat Kab. Natuna,0,0,0,0,0,0
Kec. Bunguran Timur Kab. Natuna,3,1,0,0,0,4
Kec. Serasan Kab. Natuna,2,0,0,0,0,2
Kec. Subi Kab. Natuna,0,0,0,0,0,0
Kec. Bunguran Utara Kab. Natuna,0,1,0,0,0,1
Kec. Pulau Laut Kab. Natuna,2,0,0,0,0,2
Kec. Pulau Tiga Kab. Natuna,0,0,0,0,0,0
Kec. Bunguran Timur Laut Kab. Natuna,0,0,0,0,0,0
Kec. Bunguran Tengah Kab. Natuna,2,0,0,0,0,2
Kec. Bunguran Selatan Kab. Natuna,1,1,0,0,0,2
Kec. Serasan Timur Kab. Natuna,0,0,0,0,0,0
Kec. Singkep Kab. Lingga,3,1,0,0,0,4
Kec. Lingga Kab. Lingga,0,0,0,0,0,0
Kec. Senayang Kab. Lingga,0,0,0,0,0,0
Kec. Singkep Barat Kab. Lingga,0,0,0,0,0,0
Kec. Lingga Utara Kab. Lingga,0,0,0,0,0,0
Kec. Singkep Pesisir Kab. Lingga,0,0,0,0,0,0
Kec. Singkep Selatan Kab. Lingga,0,0,0,0,0,0
Kec. Lingga Timur Kab. Lingga,0,0,0,0,0,0
Kec. Selayar Kab. Lingga,0,0,0,0,0,0
Kec. Kepulauan Posek Kab. Lingga,0,0,0,0,0,0
Kec. Bakung Serumpun Kab. Lingga,0,0,0,0,0,0
Kec. Temiang Pesisir Kab. Lingga,0,0,0,0,0,0
Kec. Katang Bidare Kab. Lingga,0,0,0,0,0,0
Kec. Jemaja Kab. Kepulauan Anambas,0,0,0,0,0,0
Kec. Siantan Kab. Kepulauan Anambas,0,0,0,0,0,0
Kec. Palmatak Kab. Kepulauan Anambas,2,0,0,0,0,2
Kec. Siantan Timur Kab. Kepulauan Anambas,0,0,0,0,0,0
Kec. Belakang Padang Kota Batam,3,1,0,0,0,4
Kec. Sekupang Kota Batam,4,0,0,0,0,4
Kec. Sei Beduk Kota Batam,0,0,0,0,0,0
Kec. Bulang Kota Batam,1,1,0,0,0,2
Kec. Lubuk Baja Kota Batam,11,1,0,0,0,12
Kec. Batu Ampar Kota Batam,3,1,0,0,0,4
Kec. Nongsa Kota Batam,4,0,0,0,0,4
Kec. Galang Kota Batam,8,2,0,0,0,10
Kec. Bengkong Kota Batam,4,2,0,0,0,6
Kec. Batam Kota Kota Batam,21,3,0,0,0,24
Kec. Sagulung Kota Batam,16,1,0,0,0,17
Kec. Batu Aji Kota Batam,2,4,0,0,0,6
Kec. Tanjung Pinang Barat Kota Tanjungpinang,8,2,0,0,0,10
Kec. Tanjung Pinang Timur Kota Tanjungpinang,6,0,0,0,0,6
Kec. Bukit Bestari Kota Tanjungpinang,11,3,0,0,0,14
Kec. Tanjung Pinang Kota Kota Tanjungpinang,2,0,0,0,0,2
Kec. Fef Kab. Tambrauw,0,0,0,0,0,0
Kec. Sausapor Kab. Tambrauw,0,0,0,0,0,0
Kec. Amberbaken Kab. Tambrauw,0,0,0,0,0,0
Kec. Kebar Kab. Tambrauw,0,2,0,0,0,2
Kec. Aifat Kab. Maybrat,0,0,0,0,0,0
Kec. Aitinyo Kab. Maybrat,0,0,0,0,0,0
Kec. Ayamaru Kab. Maybrat,0,0,0,0,0,0
Kec. Anggi Gida Kab. Pegunungan Arfak,0,0,0,0,0,0
Kec. Membey Kab. Pegunungan Arfak,0,0,0,0,0,0
Kec. Sururay Kab. Pegunungan Arfak,0,0,0,0,0,0
Kec. Catubouw Kab. Pegunungan Arfak,2,0,0,0,0,2
Kec. Testega Kab. Pegunungan Arfak,0,0,0,0,0,0
Kec. Menyambouw Kab. Pegunungan Arfak,0,0,0,0,0,0
Kec. Hingk Kab. Pegunungan Arfak,0,0,0,0,0,0
Kec. Anggi Kab. Pegunungan Arfak,0,0,0,0,0,0
Kec. Kaimana Kab. Kaimana,1,1,0,0,0,2
Kec. Wondiboy Kab. Teluk Wondama,0,0,0,0,0,0
Kec. Wasior Kab. Teluk Wondama,1,1,0,0,0,2
Kec. Windesi Kab. Teluk Wondama,0,0,0,0,0,0
Kec. Babo Kab. Teluk Bintuni,4,0,0,0,0,4
Kec. Sumuri Kab. Teluk Bintuni,0,2,0,0,0,2
Kec. Kaitaro Kab. Teluk Bintuni,0,0,0,0,0,0
Kec. Bintuni Kab. Teluk Bintuni,0,2,0,0,0,2
Kec. Tembuni Kab. Teluk Bintuni,0,0,0,0,0,0
Kec. Kamundan Kab. Teluk Bintuni,0,0,0,0,0,0
Kec. Tomu Kab. Teluk Bintuni,4,2,0,0,0,6
Kec. Meyado Kab. Teluk Bintuni,0,0,0,0,0,0
Kec. Moskona Barat Kab. Teluk Bintuni,0,0,0,0,0,0
Kec. Merdey Kab. Teluk Bintuni,0,0,0,0,0,0
Kec. Inanwatan Kab. Sorong Selatan,4,0,0,0,0,4
Kec. Kokoda Kab. Sorong Selatan,0,0,0,0,0,0
Kec. Teminabuan Kab. Sorong Selatan,0,0,0,0,0,0
Kec. Makbon Kab. Sorong,0,0,0,0,0,0
Kec. Beraur Kab. Sorong,0,0,0,0,0,0
Kec. Klamono Kab. Sorong,0,0,0,0,0,0
Kec. Salawati Kab. Sorong,0,0,0,0,0,0
Kec. Mayamuk Kab. Sorong,2,0,0,0,0,2
Kec. Seget Kab. Sorong,0,0,0,0,0,0
Kec. Segun Kab. Sorong,0,2,0,0,0,2
Kec. Salawati Selatan Kab. Sorong,0,0,0,0,0,0
Kec. Aimas Kab. Sorong,4,0,0,0,0,4
Kec. Mariat Kab. Sorong,0,0,0,0,0,0
Kec. Moisegen Kab. Sorong,0,0,0,0,0,0
Kec. Mega Kab. Sorong,0,0,0,0,0,0
Kec. Warmare Kab. Manokwari,2,0,0,0,0,2
Kec. Prafi Kab. Manokwari,0,0,0,0,0,0
Kec. Manokwari Barat Kab. Manokwari,4,4,0,0,0,8
Kec. Manokwari Timur Kab. Manokwari,2,0,0,0,0,2
Kec. Manokwari Selatan Kab. Manokwari,0,0,0,0,0,0
Kec. Masni Kab. Manokwari,0,0,0,0,0,0
Kec. Sidey Kab. Manokwari,0,0,0,0,0,0
Kec. Karas Kab. Fak-Fak,1,1,0,0,0,2
Kec. Fak-fak Kab. Fak-Fak,4,4,0,0,0,8
Kec. Fak-fak Tengah Kab. Fak-Fak,2,0,0,0,0,2
Kec. Kokas Kab. Fak-Fak,0,2,0,0,0,2
Kec. Ransiki Kab. Manokwari Selatan,2,0,0,0,0,2
Kec. Oransbari Kab. Manokwari Selatan,0,0,0,0,0,0
Kec. Nenei Kab. Manokwari Selatan,0,0,0,0,0,0
Kec. Dataran Isim Kab. Manokwari Selatan,0,0,0,0,0,0
Kec. Momi Waren Kab. Manokwari Selatan,0,0,0,0,0,0
Kec. Sorong Timur Kota Sorong,3,1,0,0,0,4
Kec. Sorong Kota Kota Sorong,1,1,0,0,0,2
Kec. Sorong Barat Kota Sorong,1,1,0,0,0,2
Kec. Sorong Kepulauan Kota Sorong,0,0,0,0,0,0
Kec. Sorong Utara Kota Sorong,4,2,0,0,0,6
Kec. Sorong Manoi Kota Sorong,4,0,0,0,0,4
Kec. Malaimsimsa Kota Sorong,3,1,0,0,0,4
Kec. Sorong Kota Sorong,2,0,0,0,0,2
Kec. Misool Selatan Kab. Raja Ampat,0,0,0,0,0,0
Kec. Misool (misool Utara) Kab. Raja Ampat,0,0,0,0,0,0
Kec. Kofiau Kab. Raja Ampat,0,0,0,0,0,0
Kec. Misool Timur Kab. Raja Ampat,0,0,0,0,0,0
Kec. Waigeo Barat Kab. Raja Ampat,0,0,0,0,0,0
Kec. Waigeo Utara Kab. Raja Ampat,0,0,0,0,0,0
Kec. Waigeo Timur Kab. Raja Ampat,0,0,0,0,0,0
Kec. Warwarbomi Kab. Raja Ampat,0,0,0,0,0,0
Kec. Misool Barat Kab. Raja Ampat,0,0,0,0,0,0
Kec. Kepulauan Sembilan Kab. Raja Ampat,0,0,0,0,0,0
Kec. Kota Waisai Kab. Raja Ampat,0,0,0,0,0,0
Kec. Batanta Utara Kab. Raja Ampat,0,0,0,0,0,0
Kec. Salawati Tengah Kab. Raja Ampat,0,0,0,0,0,0
Kec. Ayau Kab. Raja Ampat,0,0,0,0,0,0
Kec. Campalagian Kab. Polewali Mandar,4,0,0,0,0,4
Kec. Wonomulyo Kab. Polewali Mandar,4,0,0,0,0,4
Kec. Polewali Kab. Polewali Mandar,8,6,0,0,0,14
Kec. Balanipa Kab. Polewali Mandar,2,0,0,0,0,2
Kec. Alu Kab. Polewali Mandar,0,0,0,0,0,0
Kec. Mapili Kab. Polewali Mandar,2,0,0,0,0,2
Kec. Matakali Kab. Polewali Mandar,0,0,0,0,0,0
Kec. Tapango Kab. Polewali Mandar,0,0,0,0,0,0
Kec. Matangnga Kab. Polewali Mandar,0,0,0,0,0,0
Kec. Tubbitaramanu Kab. Polewali Mandar,0,0,0,0,0,0
Kec. Sumarorong Kab. Mamasa,1,1,0,0,0,2
Kec. Mamasa Kab. Mamasa,1,1,0,0,0,2
Kec. Mambi Kab. Mamasa,4,0,0,0,0,4
Kec. Tabulahan Kab. Mamasa,0,0,0,0,0,0
Kec. Messawa Kab. Mamasa,2,0,0,0,0,2
Kec. Sesenapadang Kab. Mamasa,0,0,0,0,0,0
Kec. Tandukalua Kab. Mamasa,0,0,0,0,0,0
Kec. Aralle Kab. Mamasa,2,0,0,0,0,2
Kec. Nosu Kab. Mamasa,1,1,0,0,0,2
Kec. Bambang Kab. Mamasa,0,2,0,0,0,2
Kec. Balla Kab. Mamasa,0,0,0,0,0,0
Kec. Rantebulahan Timur Kab. Mamasa,0,0,0,0,0,0
Kec. Buntumalangka Kab. Mamasa,0,0,0,0,0,0
Kec. Mehalaan Kab. Mamasa,0,0,0,0,0,0
Kec. Tapalang Kab. Mamuju,4,0,0,0,0,4
Kec. Mamuju Kab. Mamuju,2,0,0,0,0,2
Kec. Kalukku Kab. Mamuju,5,1,0,0,0,6
Kec. Kalumpang Kab. Mamuju,0,0,0,0,0,0
Kec. Tapalang Barat Kab. Mamuju,0,0,0,0,0,0
Kec. Papalang Kab. Mamuju,0,0,0,0,0,0
Kec. Sampaga Kab. Mamuju,0,0,0,0,0,0
Kec. Tommo Kab. Mamuju,0,0,0,0,0,0
Kec. Bonehau Kab. Mamuju,0,0,0,0,0,0
Kec. Simboro Kab. Mamuju,0,0,0,0,0,0
Kec. Pasangkayu Kab. Pasangkayu,8,2,0,0,0,10
Kec. Sarudu Kab. Pasangkayu,0,0,0,0,0,0
Kec. Baras Kab. Pasangkayu,0,0,0,0,0,0
Kec. Bambalamutu Kab. Pasangkayu,1,1,0,0,0,2
Kec. Dapurang Kab. Pasangkayu,2,0,0,0,0,2
Kec. Duripoku Kab. Pasangkayu,0,0,0,0,0,0
Kec. Bulu Taba Kab. Pasangkayu,0,0,0,0,0,0
Kec. Lariang Kab. Pasangkayu,0,0,0,0,0,0
Kec. Tikke Raya Kab. Pasangkayu,1,1,0,0,0,2
Kec. Bambaira Kab. Pasangkayu,1,3,0,0,0,4
Kec. Sarjo Kab. Pasangkayu,0,0,0,0,0,0
Kec. Pamboang Kab. Majene,1,1,0,0,0,2
Kec. Sendana Kab. Majene,1,1,0,0,0,2
Kec. Malunda Kab. Majene,0,0,0,0,0,0
Kec. Banggae Timur Kab. Majene,6,2,0,0,0,8
Kec. Budong-Budong Kab. Mamuju Tengah,2,1,0,0,0,3
Kec. Karossa Kab. Mamuju Tengah,1,1,0,0,0,2
Kec. Topoyo Kab. Mamuju Tengah,2,0,0,0,0,2
Kec. Tobadak Kab. Mamuju Tengah,0,0,0,0,0,0
Kec. Pangale Kab. Mamuju Tengah,0,0,0,0,0,0
Kec. Krayan Kab. Nunukan,1,1,0,0,0,2
Kec. Lumbis Kab. Nunukan,0,0,0,0,0,0
Kec. Sembakung Kab. Nunukan,0,0,0,0,0,0
Kec. Nunukan Kab. Nunukan,4,3,0,0,0,7
Kec. Sebatik Kab. Nunukan,2,0,0,0,0,2
Kec. Sebuku Kab. Nunukan,0,0,0,0,0,0
Kec. Krayan Selatan Kab. Nunukan,0,0,0,0,0,0
Kec. Nunukan Selatan Kab. Nunukan,0,0,0,0,0,0
Kec. Sebatik Utara Kab. Nunukan,0,0,0,0,0,0
Kec. Sebatik Tengah Kab. Nunukan,0,0,0,0,0,0
Kec. Tarakan Timur Kota Tarakan,4,0,0,0,0,4
Kec. Tarakan Tengah Kota Tarakan,5,3,0,0,0,8
Kec. Tarakan Barat Kota Tarakan,6,0,0,0,0,6
Kec. Tarakan Utara Kota Tarakan,2,2,0,0,0,4
Kec. Kayan Hulu Kab. Malinau,2,0,0,0,0,2
Kec. Kayan Hilir Kab. Malinau,0,0,0,0,0,0
Kec. Pujungan Kab. Malinau,0,0,0,0,0,0
Kec. Malinau Kota Kab. Malinau,1,1,0,0,0,2
Kec. Mentarang Kab. Malinau,1,1,0,0,0,2
Kec. Sungai Boh Kab. Malinau,0,0,0,0,0,0
Kec. Malinau Selatan Kab. Malinau,4,0,0,0,0,4
Kec. Malinau Barat Kab. Malinau,2,0,0,0,0,2
Kec. Malinau Utara Kab. Malinau,0,2,0,0,0,2
Kec. Kayan Selatan Kab. Malinau,0,0,0,0,0,0
Kec. Bahau Hulu Kab. Malinau,0,0,0,0,0,0
Kec. Mentarang Hulu Kab. Malinau,0,0,0,0,0,0
Kec. Malinau Selatan Hilir Kab. Malinau,0,0,0,0,0,0
Kec. Malinau Selatan Hulu Kab. Malinau,0,0,0,0,0,0
Kec. Sungai Tubu Kab. Malinau,0,0,0,0,0,0
Kec. Tanjung Palas Kab. Bulungan,2,2,0,0,0,4
Kec. Sekatak Kab. Bulungan,0,0,0,0,0,0
Kec. Pulau Bunyu Kab. Bulungan,2,0,0,0,0,2
Kec. Tanjung Palas Barat Kab. Bulungan,0,0,0,0,0,0
Kec. Tanjung Palas Utara Kab. Bulungan,1,1,0,0,0,2
Kec. Tanjung Palas Timur Kab. Bulungan,0,0,0,0,0,0
Kec. Tanjung Selor Kab. Bulungan,6,4,0,0,0,10
Kec. Tanjung Palas Tengah Kab. Bulungan,0,0,0,0,0,0
Kec. Peso Kab. Bulungan,0,2,0,0,0,2
Kec. Sesayap Kab. Tana Tidung,2,0,0,0,0,2
Kec. Sesayap Hilir Kab. Tana Tidung,4,0,0,0,0,4
Kec. Tanah Lia Kab. Tana Tidung,2,0,0,0,0,2
